년,월,일,설비용량(MW),공급능력(MW),최대전력(MW),공급예비력(MW),공급예비율(%),최대전력기준일시
2018,12,31,119092,101763,74652,27111,36.3,2018/12/31(10:00)
2018,12,30,119092,98344,67295,31049,46.1,2018/12/30(19:00)
2018,12,29,119092,99181,71171,28010,39.4,2018/12/29(01:00)
2018,12,28,119092,100841,86083,14758,17.1,2018/12/28(10:00)
2018,12,27,119092,101923,84377,17546,20.8,2018/12/27(17:00)
2018,12,26,119092,101432,79897,21535,27,2018/12/26(10:00)
2018,12,25,119092,99769,67836,31933,47.1,2018/12/25(19:00)
2018,12,24,119092,100733,77453,23280,30.1,2018/12/24(10:00)
2018,12,23,119092,98751,63817,34934,54.7,2018/12/23(24:00)
2018,12,22,119092,94130,65656,28474,43.4,2018/12/22(09:00)
2018,12,21,119092,96871,79490,17381,21.9,2018/12/21(10:00)
2018,12,20,119092,97431,81081,16350,20.2,2018/12/20(10:00)
2018,12,19,118266,97325,80550,16775,20.8,2018/12/19(10:00)
2018,12,18,118266,95992,81939,14053,17.2,2018/12/18(10:00)
2018,12,17,118266,96268,81991,14277,17.4,2018/12/17(10:00)
2018,12,16,118266,95867,65711,30156,45.9,2018/12/16(19:00)
2018,12,15,118266,97154,70400,26754,38,2018/12/15(01:00)
2018,12,14,118266,98032,83871,14161,16.9,2018/12/14(10:00)
2018,12,13,118266,97903,83702,14201,17,2018/12/13(10:00)
2018,12,12,118266,97110,83447,13663,16.4,2018/12/12(10:00)
2018,12,11,118266,98271,85463,12808,15,2018/12/11(11:00)
2018,12,10,118266,97775,83776,13999,16.7,2018/12/10(10:00)
2018,12,09,118266,95642,67263,28379,42.2,2018/12/09(19:00)
2018,12,08,118266,95541,69510,26031,37.4,2018/12/08(01:00)
2018,12,07,118266,96189,82072,14117,17.2,2018/12/07(17:00)
2018,12,06,118266,94062,78157,15905,20.4,2018/12/06(10:00)
2018,12,05,118266,95421,76287,19134,25.1,2018/12/05(10:00)
2018,12,04,118266,95299,73600,21699,29.5,2018/12/04(10:00)
2018,12,03,118266,93342,73728,19614,26.6,2018/12/03(10:00)
2018,12,02,118266,91105,60232,30873,51.3,2018/12/02(19:00)
2018,12,01,118266,93351,63484,29867,47,2018/12/01(01:00)
2018,11,30,118266,94970,74676,20294,27.2,2018/11/30(10:00)
2018,11,29,118266,93480,75914,17566,23.1,2018/11/29(10:00)
2018,11,28,118266,92262,74495,17767,23.8,2018/11/28(10:00)
2018,11,27,118266,91509,74408,17101,23,2018/11/27(10:00)
2018,11,26,118266,90334,74483,15851,21.3,2018/11/26(10:00)
2018,11,25,118266,88825,60418,28407,47,2018/11/25(19:00)
2018,11,24,118266,89340,66363,22977,34.6,2018/11/24(11:00)
2018,11,23,118266,89284,74515,14769,19.8,2018/11/23(10:00)
2018,11,22,118266,89678,73930,15748,21.3,2018/11/22(18:00)
2018,11,21,118266,88807,74205,14602,19.7,2018/11/21(17:00)
2018,11,20,118266,89359,72086,17273,24,2018/11/20(09:00)
2018,11,19,118266,89749,71325,18424,25.8,2018/11/19(18:00)
2018,11,18,118266,88836,59566,29270,49.1,2018/11/18(19:00)
2018,11,17,118266,89280,60668,28612,47.2,2018/11/17(01:00)
2018,11,16,117996,89388,71160,18228,25.6,2018/11/16(10:00)
2018,11,15,117996,88965,69041,19924,28.9,2018/11/15(18:00)
2018,11,14,117996,87850,69403,18447,26.6,2018/11/14(09:00)
2018,11,13,117996,88097,69176,18921,27.4,2018/11/13(01:00)
2018,11,12,117996,88116,67888,20228,29.8,2018/11/12(10:00)
2018,11,11,117996,85994,58243,27751,47.6,2018/11/11(19:00)
2018,11,10,117996,85852,59583,26269,44.1,2018/11/10(01:00)
2018,11,09,117996,88746,69575,19171,27.6,2018/11/09(10:00)
2018,11,08,117996,88392,71046,17346,24.4,2018/11/08(15:00)
2018,11,07,117996,86002,70063,15939,22.7,2018/11/07(10:00)
2018,11,06,117996,86299,68452,17847,26.1,2018/11/06(10:00)
2018,11,05,117996,85339,68082,17257,25.3,2018/11/05(19:00)
2018,11,04,117996,83304,58032,25272,43.5,2018/11/04(20:00)
2018,11,03,117996,84461,59940,24521,40.9,2018/11/03(01:00)
2018,11,02,117996,86318,68213,18105,26.5,2018/11/02(09:00)
2018,11,01,117996,85019,69302,15717,22.7,2018/11/01(19:00)
2018,10,31,117996,84708,69211,15497,22.4,2018/10/31(19:00)
2018,10,30,117996,84796,70329,14467,20.6,2018/10/30(19:00)
2018,10,29,117996,84867,69629,15238,21.9,2018/10/29(19:00)
2018,10,28,117996,80886,57363,23523,41,2018/10/28(20:00)
2018,10,27,117996,78853,59055,19798,33.5,2018/10/27(19:00)
2018,10,26,117996,78637,68352,10285,15,2018/10/26(10:00)
2018,10,25,117996,80187,68029,12158,17.9,2018/10/25(19:00)
2018,10,24,117996,80567,67241,13326,19.8,2018/10/24(19:00)
2018,10,23,117996,80016,68261,11755,17.2,2018/10/23(19:00)
2018,10,22,117996,80080,67942,12138,17.9,2018/10/22(19:00)
2018,10,21,117996,78562,57268,21294,37.2,2018/10/21(20:00)
2018,10,20,117996,77857,58460,19397,33.2,2018/10/20(19:00)
2018,10,19,117996,81181,66699,14482,21.7,2018/10/19(19:00)
2018,10,18,117996,81609,68273,13336,19.5,2018/10/18(19:00)
2018,10,17,117996,81346,67428,13918,20.4,2018/10/17(19:00)
2018,10,16,117996,80683,68140,12543,18.4,2018/10/16(19:00)
2018,10,15,117996,82338,67919,14419,21.2,2018/10/15(01:00)
2018,10,14,117996,80738,57197,23541,41.2,2018/10/14(20:00)
2018,10,13,117996,79514,58171,21343,36.7,2018/10/13(20:00)
2018,10,12,117996,83471,66908,16563,24.8,2018/10/12(19:00)
2018,10,11,117996,82365,67931,14434,21.2,2018/10/11(19:00)
2018,10,10,117996,80746,67212,13534,20.1,2018/10/10(19:00)
2018,10,09,117996,81359,63339,18020,28.5,2018/10/09(20:00)
2018,10,08,117996,82849,66445,16404,24.7,2018/10/08(19:00)
2018,10,07,117996,80216,56947,23269,40.9,2018/10/07(20:00)
2018,10,06,117996,80345,60380,19965,33.1,2018/10/06(11:00)
2018,10,05,117996,83732,68545,15187,22.2,2018/10/05(17:00)
2018,10,04,117996,83069,68210,14859,21.8,2018/10/04(19:00)
2018,10,03,117996,82997,63204,19793,31.3,2018/10/03(20:00)
2018,10,02,117996,83866,66291,17575,26.5,2018/10/02(19:00)
2018,10,01,117996,84255,66789,17466,26.2,2018/10/01(19:00)
2018,09,30,117996,85610,57311,28299,49.4,2018/09/30(20:00)
2018,09,29,117996,85117,59632,25485,42.7,2018/09/29(20:00)
2018,09,28,117996,87832,66524,21308,32,2018/09/28(17:00)
2018,09,27,117996,88882,65404,23478,35.9,2018/09/27(19:00)
2018,09,26,117996,87542,55992,31550,56.3,2018/09/26(20:00)
2018,09,25,117996,87802,51414,36388,70.8,2018/09/25(20:00)
2018,09,24,117996,87986,47981,40005,83.4,2018/09/24(20:00)
2018,09,23,117996,88136,51604,36532,70.8,2018/09/23(20:00)
2018,09,22,117996,89729,57029,32700,57.3,2018/09/22(20:00)
2018,09,21,117996,95074,69729,25345,36.3,2018/09/21(11:00)
2018,09,20,117996,93862,71784,22078,30.8,2018/09/20(15:00)
2018,09,19,117996,92949,72654,20295,27.9,2018/09/19(15:00)
2018,09,18,117996,92418,72897,19521,26.8,2018/09/18(17:00)
2018,09,17,117996,92041,73080,18961,25.9,2018/09/17(17:00)
2018,09,16,117996,84610,61788,22822,36.9,2018/09/16(20:00)
2018,09,15,117996,87380,64896,22484,34.6,2018/09/15(12:00)
2018,09,14,117996,92337,73530,18807,25.6,2018/09/14(15:00)
2018,09,13,117996,92278,73607,18671,25.4,2018/09/13(17:00)
2018,09,12,117996,92726,73004,19722,27,2018/09/12(17:00)
2018,09,11,117996,92845,71320,21525,30.2,2018/09/11(17:00)
2018,09,10,117996,91723,72230,19493,27,2018/09/10(17:00)
2018,09,09,117996,88849,59747,29102,48.7,2018/09/09(20:00)
2018,09,08,117996,86196,61542,24654,40.1,2018/09/08(20:00)
2018,09,07,117996,94835,73304,21531,29.4,2018/09/07(15:00)
2018,09,06,117996,94775,76604,18171,23.7,2018/09/06(15:00)
2018,09,05,117996,94830,75416,19414,25.7,2018/09/05(17:00)
2018,09,04,117996,94239,76268,17971,23.6,2018/09/04(17:00)
2018,09,03,117996,94223,78405,15818,20.2,2018/09/03(17:00)
2018,09,02,117996,91846,62574,29272,46.8,2018/09/02(20:00)
2018,09,01,117996,92587,65117,27470,42.2,2018/09/01(15:00)
2018,08,31,117996,97053,77420,19633,25.4,2018/08/31(11:00)
2018,08,30,117996,97129,81281,15848,19.5,2018/08/30(17:00)
2018,08,29,117840,97798,80284,16872,21,2018/08/29(17:00)
2018,08,28,117840,98287,79359,18928,23.9,2018/08/28(17:00)
2018,08,27,117840,98259,77224,21035,27.2,2018/08/27(17:00)
2018,08,26,117840,89602,61434,28168,45.9,2018/08/26(20:00)
2018,08,25,117840,91111,68483,22628,33,2018/08/25(14:00)
2018,08,24,117840,98764,79844,18920,23.7,2018/08/24(12:00)
2018,08,23,117840,98679,84786,13893,16.4,2018/08/23(15:00)
2018,08,22,117840,97791,87911,9880,11.2,2018/08/22(17:00)
2018,08,21,117840,98147,84025,14122,16.8,2018/08/21(17:00)
2018,08,20,117840,99274,83917,15357,18.3,2018/08/20(17:00)
2018,08,19,117840,93003,66730,26273,39.4,2018/08/19(20:00)
2018,08,18,117840,93030,67131,25899,38.6,2018/08/18(17:00)
2018,08,17,117840,99458,80289,19169,23.9,2018/08/17(17:00)
2018,08,16,117840,99943,88720,11223,12.6,2018/08/16(15:00)
2018,08,15,117840,98106,83275,14831,17.8,2018/08/15(15:00)
2018,08,14,117840,100250,91548,8702,9.5,2018/08/14(17:00)
2018,08,13,117840,100194,91405,8789,9.6,2018/08/13(17:00)
2018,08,12,117840,90835,73509,17326,23.6,2018/08/12(20:00)
2018,08,11,117840,90671,75167,15504,20.6,2018/08/11(15:00)
2018,08,10,117840,100189,87807,12382,14.1,2018/08/10(17:00)
2018,08,09,117840,99902,88582,11320,12.8,2018/08/09(17:00)
2018,08,08,117840,99829,88955,10874,12.2,2018/08/08(17:00)
2018,08,07,117840,99399,88893,10506,11.8,2018/08/07(17:00)
2018,08,06,117840,99237,88816,10421,11.7,2018/08/06(17:00)
2018,08,05,117840,95002,74791,20211,27,2018/08/05(21:00)
2018,08,04,117840,95423,74087,21336,28.8,2018/08/04(20:00)
2018,08,03,117840,99023,81589,17434,21.4,2018/08/03(17:00)
2018,08,02,117840,97975,82283,15692,19.1,2018/08/02(18:00)
2018,08,01,117840,96321,82486,13835,16.8,2018/08/01(18:00)
2018,07,31,117477,96087,83087,13000,15.6,2018/07/31(17:00)
2018,07,30,117477,96016,82882,13134,15.8,2018/07/30(17:00)
2018,07,29,117477,92104,72063,20041,27.8,2018/07/29(20:00)
2018,07,28,117477,92232,77487,14745,19,2018/07/28(12:00)
2018,07,27,117205,99117,90678,8439,9.3,2018/07/27(17:00)
2018,07,26,117205,99309,90682,8627,9.5,2018/07/26(17:00)
2018,07,25,117205,99296,90399,8897,9.8,2018/07/25(17:00)
2018,07,24,117205,99570,92478,7092,7.7,2018/07/24(17:00)
2018,07,23,117205,98296,90695,7601,8.4,2018/07/23(17:00)
2018,07,22,117205,97241,73794,23447,31.8,2018/07/22(21:00)
2018,07,21,117205,95628,76999,18629,24.2,2018/07/21(15:00)
2018,07,20,117205,97502,88080,9422,10.7,2018/07/20(17:00)
2018,07,19,117205,97937,87591,10346,11.8,2018/07/19(17:00)
2018,07,18,117205,97759,86710,11048,12.7,2018/07/18(17:00)
2018,07,17,117205,97113,86286,10827,12.5,2018/07/17(17:00)
2018,07,16,117205,95758,86306,9452,11,2018/07/16(17:00)
2018,07,15,117205,93127,69798,23329,33.4,2018/07/15(21:00)
2018,07,14,117205,92605,70700,21905,31,2018/07/14(15:00)
2018,07,13,117205,95558,82076,13482,16.4,2018/07/13(17:00)
2018,07,12,117205,96809,81393,15416,18.9,2018/07/12(17:00)
2018,07,11,117205,96148,79406,16742,21.1,2018/07/11(15:00)
2018,07,10,117205,95595,76258,19337,25.4,2018/07/10(17:00)
2018,07,09,117205,95045,70920,24125,34,2018/07/09(15:00)
2018,07,08,117205,90879,58944,31935,54.2,2018/07/08(21:00)
2018,07,07,117205,89827,60855,28972,47.6,2018/07/07(16:00)
2018,07,06,117205,91535,73639,17896,24.3,2018/07/06(15:00)
2018,07,05,117205,91119,77530,13589,17.5,2018/07/05(15:00)
2018,07,04,117205,89359,78919,10440,13.2,2018/07/04(17:00)
2018,07,03,117205,89020,77312,11708,15.1,2018/07/03(15:00)
2018,07,02,117205,89068,75611,11676,15.1,2018/07/02(15:00)
2018,07,01,117205,87679,60609,27070,44.7,2018/07/01(21:00)
2018,06,30,117205,88076,65571,22505,34.3,2018/06/30(14:00)
2018,06,29,117111,89332,75049,14283,19,2018/06/29(17:00)
2018,06,28,117111,88067,74820,13247,17.7,2018/06/28(15:00)
2018,06,27,117111,87793,74803,12990,17.4,2018/06/27(17:00)
2018,06,26,117111,89067,75237,13830,18.4,2018/06/26(17:00)
2018,06,25,117111,87256,76606,10650,13.9,2018/06/25(17:00)
2018,06,24,117111,84269,60899,23370,38.4,2018/06/24(21:00)
2018,06,23,117111,83862,61832,22030,35.6,2018/06/23(15:00)
2018,06,22,117111,86209,73832,12377,16.8,2018/06/22(17:00)
2018,06,21,117790,86791,72656,14135,19.5,2018/06/21(17:00)
2018,06,20,117790,85079,72551,12528,17.3,2018/06/20(17:00)
2018,06,19,117790,84861,72215,12646,17.5,2018/06/19(15:00)
2018,06,18,117790,84329,73210,11119,15.2,2018/06/18(17:00)
2018,06,17,117790,83729,58275,25454,43.7,2018/06/17(21:00)
2018,06,16,117790,83170,58833,24337,41.4,2018/06/16(21:00)
2018,06,15,117790,85115,68421,16694,24.4,2018/06/15(17:00)
2018,06,14,117790,85370,68133,17237,25.3,2018/06/14(17:00)
2018,06,13,117790,85139,65009,20130,31,2018/06/13(15:00)
2018,06,12,117790,84032,68930,15102,21.9,2018/06/12(17:00)
2018,06,11,117790,84435,68243,16192,23.7,2018/06/11(17:00)
2018,06,10,117790,83297,56753,26544,46.8,2018/06/10(21:00)
2018,06,09,117790,82730,61116,21614,35.4,2018/06/09(15:00)
2018,06,08,117790,83419,71187,12232,17.2,2018/06/08(17:00)
2018,06,07,117790,82558,73379,9179,12.5,2018/06/07(17:00)
2018,06,06,117790,82133,65117,17016,26.1,2018/06/06(17:00)
2018,06,05,117790,82500,71221,11279,15.8,2018/06/05(17:00)
2018,06,04,117790,81586,71429,10157,14.2,2018/06/04(17:00)
2018,06,03,117790,79806,58359,21447,36.8,2018/06/03(21:00)
2018,06,02,117790,80601,59990,20611,34.4,2018/06/02(15:00)
2018,06,01,117790,83704,70127,13577,19.4,2018/06/01(17:00)
2018,05,31,117790,84738,69024,15714,22.8,2018/05/31(17:00)
2018,05,30,117589,83449,70407,13042,18.5,2018/05/30(15:00)
2018,05,29,117589,81615,70664,10951,15.5,2018/05/29(17:00)
2018,05,28,117589,80264,70232,10032,14.3,2018/05/28(17:00)
2018,05,27,117589,78783,56576,22207,39.3,2018/05/27(21:00)
2018,05,26,117589,76661,58811,17850,30.4,2018/05/26(21:00)
2018,05,25,117589,80698,67071,13627,20.3,2018/05/25(15:00)
2018,05,24,117589,79966,66977,12989,19.4,2018/05/24(17:00)
2018,05,23,117589,80982,65409,15573,23.8,2018/05/23(17:00)
2018,05,22,117589,81093,60900,20193,33.2,2018/05/22(17:00)
2018,05,21,117589,80612,64307,16305,25.4,2018/05/21(17:00)
2018,05,20,117589,78999,55326,23673,42.8,2018/05/20(21:00)
2018,05,19,117589,79015,57867,21148,36.5,2018/05/19(11:00)
2018,05,18,117589,81942,70160,11782,16.8,2018/05/18(11:00)
2018,05,17,117589,82000,73173,8827,12.1,2018/05/17(15:00)
2018,05,16,117589,82967,72229,10738,14.9,2018/05/16(15:00)
2018,05,15,117589,80592,70067,10525,15,2018/05/15(17:00)
2018,05,14,117589,79618,66805,12813,19.2,2018/05/14(17:00)
2018,05,13,117589,76940,55959,20981,37.5,2018/05/13(21:00)
2018,05,12,117589,75171,60553,14618,24.1,2018/05/12(11:00)
2018,05,11,117589,79009,65425,13584,20.8,2018/05/11(17:00)
2018,05,10,117589,79074,65752,13322,20.3,2018/05/10(17:00)
2018,05,09,117589,79444,65350,14094,21.6,2018/05/09(17:00)
2018,05,08,117589,79415,65600,13815,21.1,2018/05/08(17:00)
2018,05,07,117589,80891,60354,20537,34,2018/05/07(21:00)
2018,05,06,117589,80610,55321,25289,45.7,2018/05/06(21:00)
2018,05,05,117589,79174,56278,22896,40.7,2018/05/05(01:00)
2018,05,04,117589,81094,63828,17266,27.1,2018/05/04(17:00)
2018,05,03,116747,80297,65747,14550,22.1,2018/05/03(20:00)
2018,05,02,116747,81261,67840,13421,19.8,2018/05/02(15:00)
2018,05,01,116747,81580,60435,21145,35,2018/05/01(20:00)
2018,04,30,116747,80785,64781,16004,24.7,2018/04/30(17:00)
2018,04,29,116747,77172,55893,21279,38.1,2018/04/29(21:00)
2018,04,28,116747,78144,56946,21198,37.2,2018/04/28(21:00)
2018,04,27,116747,79175,64547,14628,22.7,2018/04/27(17:00)
2018,04,26,116747,78154,65403,12751,19.5,2018/04/26(20:00)
2018,04,25,116747,76747,64939,11808,18.2,2018/04/25(20:00)
2018,04,24,116747,79133,68449,10684,15.6,2018/04/24(11:00)
2018,04,23,116747,79894,69692,10202,14.6,2018/04/23(11:00)
2018,04,22,116747,77731,56420,21311,37.8,2018/04/22(20:00)
2018,04,21,116747,78552,57277,21275,37.1,2018/04/21(20:00)
2018,04,20,116747,78947,65575,13372,20.4,2018/04/20(17:00)
2018,04,19,116747,78924,66264,12660,19.1,2018/04/19(20:00)
2018,04,18,116747,78400,65506,12894,19.7,2018/04/18(20:00)
2018,04,17,116747,77568,66456,11112,16.7,2018/04/17(20:00)
2018,04,16,116747,79121,65800,13321,20.2,2018/04/16(20:00)
2018,04,15,116747,80067,56623,23444,41.4,2018/04/15(21:00)
2018,04,14,116747,81200,62481,18719,30,2018/04/14(11:00)
2018,04,13,116747,81726,66251,15475,23.4,2018/04/13(10:00)
2018,04,12,116747,81768,66438,15330,23.1,2018/04/12(20:00)
2018,04,11,116747,81614,65533,16081,24.5,2018/04/11(20:00)
2018,04,10,116747,82433,66523,15910,23.9,2018/04/10(20:00)
2018,04,09,116747,83521,68149,15372,22.6,2018/04/09(10:00)
2018,04,08,116747,82219,58110,24109,41.5,2018/04/08(20:00)
2018,04,07,116747,81063,60912,20151,33.1,2018/04/07(11:00)
2018,04,06,116747,83403,69296,14107,20.4,2018/04/06(10:00)
2018,04,05,116747,84634,70520,14114,20,2018/04/05(11:00)
2018,04,04,116747,85253,68281,16972,24.9,2018/04/04(11:00)
2018,04,03,116747,84946,66335,18611,28.1,2018/04/03(20:00)
2018,04,02,116747,83579,65846,17733,26.9,2018/04/02(20:00)
2018,04,01,116747,84193,56397,27796,49.3,2018/04/01(20:00)
2018,03,31,116747,85067,57558,27509,47.8,2018/03/31(01:00)
2018,03,30,116747,89166,65637,23529,35.8,2018/03/30(10:00)
2018,03,29,116747,87826,67110,20716,30.9,2018/03/29(10:00)
2018,03,28,116747,87816,66068,21748,32.9,2018/03/28(10:00)
2018,03,27,116747,88147,67622,20525,30.4,2018/03/27(10:00)
2018,03,26,116747,89715,69467,20248,29.1,2018/03/26(10:00)
2018,03,25,116747,86394,57513,28881,50.2,2018/03/25(23:00)
2018,03,24,116747,87003,61698,25305,41,2018/03/24(01:00)
2018,03,23,116747,89581,72231,17350,24,2018/03/23(10:00)
2018,03,22,116747,90196,73423,16773,22.8,2018/03/22(10:00)
2018,03,21,116747,90501,78017,12484,16,2018/03/21(11:00)
2018,03,20,116747,90937,72583,18354,25.3,2018/03/20(11:00)
2018,03,19,116747,90418,72795,17623,24.2,2018/03/19(11:00)
2018,03,18,116747,88083,58324,29259,50.2,2018/03/18(23:00)
2018,03,17,116747,87175,61946,25229,40.7,2018/03/17(01:00)
2018,03,16,116747,91314,72510,18804,25.9,2018/03/16(10:00)
2018,03,15,116747,90695,71174,19521,27.4,2018/03/15(11:00)
2018,03,14,116747,90597,68060,22537,33.1,2018/03/14(09:00)
2018,03,13,116747,90231,71017,19214,27.1,2018/03/13(10:00)
2018,03,12,116747,88956,73285,15671,21.4,2018/03/12(10:00)
2018,03,11,116747,85495,59781,25714,43,2018/03/11(24:00)
2018,03,10,116747,86257,64427,21830,33.9,2018/03/10(01:00)
2018,03,09,116747,90418,75922,14496,19.1,2018/03/09(10:00)
2018,03,08,116747,90761,78855,11906,15.1,2018/03/08(11:00)
2018,03,07,116747,90131,75974,14157,18.6,2018/03/07(10:00)
2018,03,06,116747,91932,74384,17548,23.6,2018/03/06(10:00)
2018,03,05,116428,91613,77198,14415,18.7,2018/03/05(11:00)
2018,03,04,116428,88452,58887,29565,50.2,2018/03/04(20:00)
2018,03,03,116428,90231,64571,25660,39.7,2018/03/03(01:00)
2018,03,02,116428,93668,76433,17235,22.5,2018/03/02(10:00)
2018,03,01,116428,93988,68728,25260,36.8,2018/03/01(20:00)
2018,02,28,116428,96527,78122,18405,23.6,2018/02/28(15:00)
2018,02,27,116428,96476,77133,19343,25.1,2018/02/27(10:00)
2018,02,26,116428,96486,76656,19830,25.9,2018/02/26(10:00)
2018,02,25,116428,94215,63005,31210,49.5,2018/02/25(24:00)
2018,02,24,116428,91253,66278,24975,37.7,2018/02/24(11:00)
2018,02,23,116428,97115,79069,18046,22.8,2018/02/23(10:00)
2018,02,22,116428,97291,79662,17629,22.1,2018/02/22(10:00)
2018,02,21,116428,97072,80128,16944,21.1,2018/02/21(10:00)
2018,02,20,116428,96945,79383,17562,22.1,2018/02/20(10:00)
2018,02,19,116428,97460,76438,21022,27.5,2018/02/19(11:00)
2018,02,18,116428,92300,61172,31128,50.9,2018/02/18(24:00)
2018,02,17,116428,91080,59867,31213,52.1,2018/02/17(24:00)
2018,02,16,116428,91926,57733,34193,59.2,2018/02/16(24:00)
2018,02,15,116428,96010,63182,32828,52,2018/02/15(01:00)
2018,02,14,116428,98260,77843,20417,26.2,2018/02/14(10:00)
2018,02,13,116428,99516,83809,15707,18.7,2018/02/13(10:00)
2018,02,12,116428,99856,86637,13219,15.3,2018/02/12(11:00)
2018,02,11,116428,96307,68538,27769,40.5,2018/02/11(24:00)
2018,02,10,116428,95524,71240,24284,34.1,2018/02/10(11:00)
2018,02,09,116428,100220,84660,15560,18.4,2018/02/09(10:00)
2018,02,08,116428,99882,87277,12605,14.4,2018/02/08(10:00)
2018,02,07,116428,101050,87513,13537,15.5,2018/02/07(11:00)
2018,02,06,116428,101148,88238,12910,14.6,2018/02/06(10:00)
2018,02,05,116428,100724,87623,13101,15,2018/02/05(11:00)
2018,02,04,116428,95710,69711,25999,37.3,2018/02/04(24:00)
2018,02,03,116428,96130,72685,23445,32.3,2018/02/03(11:00)
2018,02,02,116428,100029,84653,15376,18.2,2018/02/02(10:00)
2018,02,01,116428,100239,83904,16335,19.5,2018/02/01(10:00)
2018,01,31,116428,99706,85260,14446,16.9,2018/01/31(10:00)
2018,01,30,116428,99203,86754,12449,14.3,2018/01/30(10:00)
2018,01,29,116428,99605,86561,13044,15.1,2018/01/29(11:00)
2018,01,28,116428,95051,68496,26555,38.8,2018/01/28(01:00)
2018,01,27,116428,97365,74418,22947,30.8,2018/01/27(01:00)
2018,01,26,116428,99232,87063,12169,14,2018/01/26(11:00)
2018,01,25,116428,99147,87247,11900,13.6,2018/01/25(17:00)
2018,01,24,116428,98511,86277,12234,14.2,2018/01/24(17:00)
2018,01,23,116428,98318,85442,12876,15.1,2018/01/23(11:00)
2018,01,22,116428,97485,80609,16876,20.9,2018/01/22(11:00)
2018,01,21,116428,94866,63917,30949,48.4,2018/01/21(24:00)
2018,01,20,116428,92979,67813,25166,37.1,2018/01/20(11:00)
2018,01,19,116428,96839,79633,17206,21.6,2018/01/19(10:00)
2018,01,18,116428,96327,79748,16579,20.8,2018/01/18(10:00)
2018,01,17,116428,95696,80766,14930,18.5,2018/01/17(11:00)
2018,01,16,116428,96018,82564,13454,16.3,2018/01/16(11:00)
2018,01,15,116428,95204,80495,14709,18.3,2018/01/15(10:00)
2018,01,14,116428,94636,66286,28350,42.8,2018/01/14(01:00)
2018,01,13,116428,93735,72843,20892,28.7,2018/01/13(11:00)
2018,01,12,116428,98988,85497,13491,15.8,2018/01/12(11:00)
2018,01,11,116428,98986,85612,13374,15.6,2018/01/11(11:00)
2018,01,10,116428,99146,84978,14168,16.7,2018/01/10(11:00)
2018,01,09,116428,98786,84021,14765,17.6,2018/01/09(11:00)
2018,01,08,116428,98246,83012,15234,18.4,2018/01/08(11:00)
2018,01,07,116428,94608,64428,30180,46.8,2018/01/07(01:00)
2018,01,06,116428,94963,68502,26461,38.6,2018/01/06(11:00)
2018,01,05,116428,98798,82551,16247,19.7,2018/01/05(10:00)
2018,01,04,116428,98111,84027,14084,16.8,2018/01/04(11:00)
2018,01,03,116428,98830,81596,17234,21.1,2018/01/03(10:00)
2018,01,02,116428,98255,79331,18924,23.9,2018/01/02(11:00)
2018,01,01,116428,97398,62145,35253,56.7,2018/01/01(24:00)
2017,12,31,116908,96958,62446,34512,55.3,2017/12/31(24:00)
2017,12,30,116908,95536,64779,30757,47.5,2017/12/30(11:00)
2017,12,29,116908,97981,78857,19124,24.3,2017/12/29(10:00)
2017,12,28,116908,97955,83478,14477,17.3,2017/12/28(10:00)
2017,12,27,116657,98281,83589,14692,17.6,2017/12/27(10:00)
2017,12,26,116657,97780,81374,16406,20.2,2017/12/26(10:00)
2017,12,25,116657,96082,66498,29584,44.5,2017/12/25(19:00)
2017,12,24,116657,94461,63302,31159,49.2,2017/12/24(24:00)
2017,12,23,116657,93545,67211,26334,39.2,2017/12/23(11:00)
2017,12,22,116657,93545,81852,13992,17.1,2017/12/22(10:00)
2017,12,21,116657,94978,83450,11528,13.8,2017/12/21(10:00)
2017,12,20,116657,97205,83664,13541,16.2,2017/12/20(10:00)
2017,12,19,116657,97171,83873,13298,15.9,2017/12/19(10:00)
2017,12,18,116657,96581,84640,11941,14.1,2017/12/18(11:00)
2017,12,17,116657,95078,66825,28253,42.3,2017/12/17(19:00)
2017,12,16,116657,92603,70890,21713,30.6,2017/12/16(11:00)
2017,12,15,116657,96407,84115,12292,14.6,2017/12/15(10:00)
2017,12,14,116657,97828,84968,12860,15.1,2017/12/14(10:00)
2017,12,13,116657,97418,84012,13406,16,2017/12/13(10:00)
2017,12,12,116657,96095,85133,10962,12.9,2017/12/12(10:00)
2017,12,11,116657,95498,83927,11571,13.8,2017/12/11(18:00)
2017,12,10,116657,90784,64000,26784,41.9,2017/12/10(24:00)
2017,12,09,116657,88449,68767,19682,28.6,2017/12/09(11:00)
2017,12,08,116657,92551,81361,11190,13.8,2017/12/08(10:00)
2017,12,07,116657,91572,80127,11445,14.3,2017/12/07(11:00)
2017,12,06,116657,91812,80911,12776,16.1,2017/12/06(10:00)
2017,12,05,116657,91914,80788,11126,13.8,2017/12/05(10:00)
2017,12,04,116657,92469,79221,13248,16.7,2017/12/04(18:00)
2017,12,03,116278,91700,61218,30482,49.8,2017/12/03(19:00)
2017,12,02,116278,92906,66179,26727,40.4,2017/12/02(11:00)
2017,12,01,116278,92783,77668,15115,19.5,2017/12/01(10:00)
2017,11,30,116278,92483,77048,15435,20,2017/11/30(10:00)
2017,11,29,116278,93866,74378,19488,26.2,2017/11/29(10:00)
2017,11,28,116278,93583,76519,17064,22.3,2017/11/28(10:00)
2017,11,27,116278,92971,76318,16653,21.8,2017/11/27(10:00)
2017,11,26,116278,88497,61257,27240,44.5,2017/11/26(24:00)
2017,11,25,116278,86553,65980,20573,31.2,2017/11/25(11:00)
2017,11,24,116278,92807,77605,15202,19.6,2017/11/24(10:00)
2017,11,23,116278,92783,77003,15780,20.5,2017/11/23(11:00)
2017,11,22,115900,91187,77349,13838,17.9,2017/11/22(11:00)
2017,11,21,115900,90278,77327,12951,16.7,2017/11/21(10:00)
2017,11,20,115900,91442,76794,14648,19.1,2017/11/20(18:00)
2017,11,19,115900,90095,61715,28380,46,2017/11/19(19:00)
2017,11,18,115900,89274,64400,24874,38.6,2017/11/18(19:00)
2017,11,17,115900,92398,74345,18053,24.3,2017/11/17(11:00)
2017,11,16,115900,91217,72971,18246,25,2017/11/16(18:00)
2017,11,15,115900,89682,72590,17704,24.6,2017/11/15(18:00)
2017,11,14,115900,87731,70501,17171,24.4,2017/11/14(18:00)
2017,11,13,115900,87918,70689,17229,24.4,2017/11/13(11:00)
2017,11,12,115900,87050,57618,29432,51.1,2017/11/12(19:00)
2017,11,11,115900,85993,59621,26372,44.2,2017/11/11(19:00)
2017,11,10,115900,85972,68299,17673,25.9,2017/11/10(17:00)
2017,11,09,115900,88234,67500,20734,30.7,2017/11/09(19:00)
2017,11,08,115900,88117,66862,21255,31.8,2017/11/08(18:00)
2017,11,07,115900,87229,67851,19378,28.6,2017/11/07(19:00)
2017,11,06,115900,88088,68148,19940,29.3,2017/11/06(19:00)
2017,11,05,115900,85517,56809,28708,50.5,2017/11/05(19:00)
2017,11,04,115900,83556,58933,24623,41.8,2017/11/04(19:00)
2017,11,03,115900,85673,66731,18942,28.4,2017/11/03(17:00)
2017,11,02,115900,86093,67063,19030,28.4,2017/11/02(19:00)
2017,11,01,115900,85425,66262,19163,28.9,2017/11/01(17:00)
2017,10,31,115900,87081,67675,19406,28.7,2017/10/31(19:00)
2017,10,30,115900,87521,68265,19256,28.2,2017/10/30(19:00)
2017,10,29,115900,84929,56295,28634,50.9,2017/10/29(20:00)
2017,10,28,115900,83421,58510,24911,42.6,2017/10/28(19:00)
2017,10,27,115900,86125,66589,19536,29.3,2017/10/27(19:00)
2017,10,26,115900,85521,67751,17770,26.2,2017/10/26(19:00)
2017,10,25,115900,87495,67111,20384,30.4,2017/10/25(19:00)
2017,10,24,115900,86397,67971,18426,27.1,2017/10/24(19:00)
2017,10,23,115900,87936,67501,20435,30.3,2017/10/23(19:00)
2017,10,22,115900,88162,56047,32115,57.3,2017/10/22(20:00)
2017,10,21,115900,86319,58896,27423,46.6,2017/10/21(19:00)
2017,10,20,115900,87499,66981,205180,30.6,2017/10/20(19:00)
2017,10,19,115900,86417,68224,19840,29.3,2017/10/19(19:00)
2017,10,18,115900,86343,67701,18642,27.5,2017/10/18(17:00)
2017,10,17,115900,85546,68021,17525,25.8,2017/10/17(19:00)
2017,10,16,115900,84250,67783,16467,24.3,2017/10/16(19:00)
2017,10,15,115249,83035,56499,26536,47,2017/10/15(20:00)
2017,10,14,115249,85314,58848,26466,45,2017/10/14(19:00)
2017,10,13,115249,87471,66400,21071,31.7,2017/10/13(19:00)
2017,10,12,115249,89422,67158,22264,33.2,2017/10/12(19:00)
2017,10,11,115249,89078,68423,20655,30.2,2017/10/11(11:00)
2017,10,10,115249,88736,70113,18623,26.6,2017/10/10(17:00)
2017,10,09,115249,88352,62781,25571,40.7,2017/10/09(19:00)
2017,10,08,115249,84897,56165,28732,51.2,2017/10/08(20:00)
2017,10,07,115249,84897,54716,30181,55.2,2017/10/07(20:00)
2017,10,06,115249,85300,52312,32988,63.1,2017/10/06(20:00)
2017,10,05,115249,86206,48919,37287,76.2,2017/10/05(20:00)
2017,10,04,115249,90044,46004,44040,95.7,2017/10/04(20:00)
2017,10,03,115249,89682,48934,40748,83.3,2017/10/03(20:00)
2017,10,02,115249,90276,55447,34829,62.8,2017/10/02(20:00)
2017,10,01,115249,89766,56530,33236,58.8,2017/10/01(20:00)
2017,09,30,115249,90193,58351,31842,54.6,2017/09/30(19:00)
2017,09,29,115249,93193,64707,28486,44,2017/09/29(18:00)
2017,09,28,114206,91397,68330,23067,33.8,2017/09/28(17:00)
2017,09,27,114206,90947,70978,19969,28.1,2017/09/27(15:00)
2017,09,26,114206,92144,72947,19197,26.3,2017/09/26(17:00)
2017,09,25,114206,91820,72798,19022,26.1,2017/09/25(17:00)
2017,09,24,114206,89652,59195,30457,51.5,2017/09/24(20:00)
2017,09,23,114206,89309,61791,27518,44.5,2017/09/23(15:00)
2017,09,22,114206,91816,69987,21829,31.2,2017/09/22(17:00)
2017,09,21,114206,91777,69362,22415,32.3,2017/09/21(17:00)
2017,09,20,114206,92456,68979,23477,34,2017/09/20(17:00)
2017,09,19,114206,92665,73115,19550,26.7,2017/09/19(16:00)
2017,09,18,114206,92551,71299,21252,29.8,2017/09/18(17:00)
2017,09,17,114206,87659,58088,29571,50.9,2017/09/17(20:00)
2017,09,16,114206,88214,60602,27612,45.6,2017/09/16(15:00)
2017,09,15,114206,92279,69521,22758,32.7,2017/09/15(17:00)
2017,09,14,114206,94191,71099,23092,32.5,2017/09/14(17:00)
2017,09,13,114206,93014,70373,22641,32.2,2017/09/13(17:00)
2017,09,12,114206,92313,72229,20084,27.8,2017/09/12(17:00)
2017,09,11,114206,92651,70946,21705,30.6,2017/09/11(15:00)
2017,09,10,114206,88745,59509,29236,49.1,2017/09/10(20:00)
2017,09,09,114206,89779,64087,25692,40.1,2017/09/09(15:00)
2017,09,08,114206,93909,73038,20871,28.6,2017/09/08(17:00)
2017,09,07,114206,94511,71699,22812,31.8,2017/09/07(17:00)
2017,09,06,114206,95006,71880,23126,32.2,2017/09/06(15:00)
2017,09,05,114206,94499,71944,22555,31.4,2017/09/05(15:00)
2017,09,04,114206,92846,72688,20158,27.7,2017/09/04(15:00)
2017,09,03,114206,91678,58814,32864,55.9,2017/09/03(20:00)
2017,09,02,114206,91533,61591,29942,48.6,2017/09/02(15:00)
2017,09,01,114206,94100,70931,23169,32.7,2017/09/01(17:00)
2017,08,31,114206,95847,70229,25618,36.5,2017/08/31(17:00)
2017,08,30,114206,96569,68797,27772,40.4,2017/08/30(16:00)
2017,08,29,114206,96582,71234,25348,35.6,2017/08/29(17:00)
2017,08,28,114206,95752,75454,20298,26.9,2017/08/28(15:00)
2017,08,27,114206,91074,59950,31124,51.9,2017/08/27(20:00)
2017,08,26,114206,91577,63547,28030,44.1,2017/08/26(15:00)
2017,08,25,114206,94808,79071,15737,19.9,2017/08/25(15:00)
2017,08,24,114206,95345,83432,11913,14.3,2017/08/24(15:00)
2017,08,23,114206,94851,83840,11011,13.1,2017/08/23(15:00)
2017,08,22,114206,94813,80879,13934,17.2,2017/08/22(17:00)
2017,08,21,114206,94942,79104,15838,20,2017/08/21(15:00)
2017,08,20,114206,91390,62497,28893,46.2,2017/08/20(20:00)
2017,08,19,114206,93359,67973,25386,37.3,2017/08/19(15:00)
2017,08,18,114206,95321,77648,17673,22.8,2017/08/18(17:00)
2017,08,17,114206,95799,77288,18511,24,2017/08/17(17:00)
2017,08,16,114206,95468,75902,19566,25.8,2017/08/16(15:00)
2017,08,15,114206,93361,67072,26289,39.2,2017/08/15(15:00)
2017,08,14,114206,94832,72855,21977,30.2,2017/08/14(15:00)
2017,08,13,114206,90404,61500,28904,47,2017/08/13(20:00)
2017,08,12,114206,91506,69570,21936,31.5,2017/08/12(15:00)
2017,08,11,113351,95564,80629,14935,18.5,2017/08/11(15:00)
2017,08,10,113351,94592,79807,14785,18.5,2017/08/10(17:00)
2017,08,09,113351,93714,80418,13296,16.5,2017/08/09(15:00)
2017,08,08,113351,94804,83775,11029,13.2,2017/08/08(15:00)
2017,08,07,113351,95125,84489,10636,12.6,2017/08/07(15:00)
2017,08,06,113351,88398,70906,17492,24.7,2017/08/06(21:00)
2017,08,05,113351,88265,72300,15965,22.1,2017/08/05(15:00)
2017,08,04,113351,91769,76990,14779,19.2,2017/08/04(17:00)
2017,08,03,113351,93031,74343,18688,25.1,2017/08/03(17:00)
2017,08,02,113351,93550,73103,20447,28,2017/08/02(17:00)
2017,08,01,113351,93092,71974,21118,29.3,2017/08/01(17:00)
2017,07,31,113351,93121,69467,23654,34.1,2017/07/31(15:00)
2017,07,30,113351,91077,63971,27106,42.4,2017/07/30(21:00)
2017,07,29,113351,90645,66214,24431,36.9,2017/07/29(12:00)
2017,07,28,113351,95482,78700,16782,21.3,2017/07/28(15:00)
2017,07,27,113351,95140,79180,15960,20.2,2017/07/27(17:00)
2017,07,26,113351,95163,80610,14553,18.1,2017/07/26(17:00)
2017,07,25,113351,94780,83321,11459,13.8,2017/07/25(15:00)
2017,07,24,113351,94461,82052,12409,15.1,2017/07/24(12:00)
2017,07,23,113351,89993,68319,21674,31.7,2017/07/23(21:00)
2017,07,22,113351,90733,75408,15325,20.3,2017/07/22(15:00)
2017,07,21,113351,94987,84586,10401,12.3,2017/07/21(17:00)
2017,07,20,113351,94712,84558,10154,12,2017/07/20(15:00)
2017,07,19,113351,94157,82682,11475,13.9,2017/07/19(17:00)
2017,07,18,113305,94706,80430,14276,17.7,2017/07/18(17:00)
2017,07,17,113305,93900,81042,12858,15.9,2017/07/17(15:00)
2017,07,16,113305,89317,65320,23997,36.7,2017/07/16(21:00)
2017,07,15,113305,89847,69532,20315,29.2,2017/07/15(12:00)
2017,07,14,113305,93437,83214,10223,12.3,2017/07/14(15:00)
2017,07,13,113305,92621,81830,10791,13.2,2017/07/13(17:00)
2017,07,12,113305,91477,80087,11390,14.2,2017/07/12(15:00)
2017,07,11,113305,92247,79685,12562,15.8,2017/07/11(15:00)
2017,07,10,113305,92732,78441,14291,18.2,2017/07/10(15:00)
2017,07,09,113305,88021,64400,23621,36.7,2017/07/09(21:00)
2017,07,08,113305,89545,68187,21358,31.3,2017/07/08(12:00)
2017,07,07,113305,93549,78640,14909,19,2017/07/07(15:00)
2017,07,06,113305,91939,80673,11266,14,2017/07/06(15:00)
2017,07,05,113305,89667,78494,11173,14.2,2017/07/05(15:00)
2017,07,04,113305,91290,78325,12965,16.6,2017/07/04(15:00)
2017,07,03,113305,92113,77051,15062,19.5,2017/07/03(15:00)
2017,07,02,113305,87819,61902,25917,41.9,2017/07/02(21:00)
2017,07,01,113305,86424,64637,21787,33.7,2017/07/01(15:00)
2017,06,30,113705,87888,75413,12475,16.5,2017/06/30(15:00)
2017,06,29,113705,87585,74958,12627,16.8,2017/06/29(15:00)
2017,06,28,113705,87698,74442,13256,17.8,2017/06/28(15:00)
2017,06,27,113705,87531,73199,14322,19.6,2017/06/27(15:00)
2017,06,26,113705,87820,73186,14634,20,2017/06/26(15:00)
2017,06,25,113705,85323,58182,27141,46.6,2017/06/25(21:00)
2017,06,24,113705,83428,63296,20132,31.8,2017/06/24(15:00)
2017,06,23,112779,86724,75077,11647,15.5,2017/06/23(15:00)
2017,06,22,112779,86466,73196,13270,18.1,2017/06/22(17:00)
2017,06,21,112779,86441,73408,13033,17.8,2017/06/21(15:00)
2017,06,20,111729,85132,73961,11171,15.1,2017/06/20(15:00)
2017,06,19,111729,85006,72473,12533,17.3,2017/06/19(17:00)
2017,06,18,112316,81885,57785,24100,41.7,2017/06/18(21:00)
2017,06,17,112316,83591,61261,22330,36.5,2017/06/17(15:00)
2017,06,16,112316,86941,71332,15609,21.9,2017/06/16(17:00)
2017,06,15,112316,84747,70246,14501,20.6,2017/06/15(17:00)
2017,06,14,112316,85205,68179,17026,25,2017/06/14(17:00)
2017,06,13,112316,84907,68006,16901,24.9,2017/06/13(15:00)
2017,06,12,111292,83421,66895,16526,24.7,2017/06/12(15:00)
2017,06,11,111292,83161,55233,27928,50.6,2017/06/11(21:00)
2017,06,10,111292,82165,58759,23406,39.8,2017/06/10(15:00)
2017,06,09,111292,83707,67241,16466,24.5,2017/06/09(16:00)
2017,06,08,111292,81647,66753,14894,22.3,2017/06/08(17:00)
2017,06,07,111292,82683,67008,15675,23.4,2017/06/07(15:00)
2017,06,06,111292,81083,61087,19996,32.7,2017/06/06(15:00)
2017,06,05,111292,81483,65530,15953,24.3,2017/06/05(17:00)
2017,06,04,111292,77623,54654,22969,42,2017/06/04(21:00)
2017,06,03,111292,76968,56898,20070,35.3,2017/06/03(15:00)
2017,06,02,111292,82221,65633,16588,25.3,2017/06/02(17:00)
2017,06,01,111292,81837,68853,12984,18.9,2017/06/01(15:00)
2017,05,31,111292,81665,69234,12431,18,2017/05/31(15:00)
2017,05,30,111292,82497,69887,12610,18,2017/05/30(15:00)
2017,05,29,111292,83014,69854,13160,18.8,2017/05/29(17:00)
2017,05,28,111292,82527,55277,27250,49.3,2017/05/28(21:00)
2017,05,27,111292,81212,56633,24579,43.4,2017/05/27(11:00)
2017,05,26,111292,83009,64402,18607,28.9,2017/05/26(17:00)
2017,05,25,111292,81835,67007,14828,22.1,2017/05/25(17:00)
2017,05,24,111292,83178,67810,15368,22.7,2017/05/24(15:00)
2017,05,23,111292,82751,67772,14979,22.1,2017/05/23(17:00)
2017,05,22,111292,81274,67482,13792,20.4,2017/05/22(17:00)
2017,05,21,111292,81065,55580,25485,45.9,2017/05/21(21:00)
2017,05,20,111292,80072,58028,22044,38,2017/05/20(15:00)
2017,05,19,111168,80693,66619,14074,21.1,2017/05/19(17:00)
2017,05,18,111168,80633,66176,14457,21.8,2017/05/18(17:00)
2017,05,17,111168,79301,65506,13795,21.1,2017/05/17(17:00)
2017,05,16,111168,80844,64434,16410,25.5,2017/05/16(17:00)
2017,05,15,111168,81620,64452,17168,26.6,2017/05/15(17:00)
2017,05,14,111168,77523,54246,23277,42.9,2017/05/14(21:00)
2017,05,13,111168,78407,57892,20515,35.4,2017/05/13(01:00)
2017,05,12,111168,80398,66500,13898,20.9,2017/05/12(11:00)
2017,05,11,111168,80138,65315,14823,22.7,2017/05/11(17:00)
2017,05,10,111168,80821,65137,15684,24.1,2017/05/10(11:00)
2017,05,09,111168,79013,61163,17850,29.2,2017/05/09(15:00)
2017,05,08,111168,77697,63803,13894,21.8,2017/05/08(17:00)
2017,05,07,111168,80272,53449,26823,50.2,2017/05/07(21:00)
2017,05,06,110671,79430,53271,26159,49.1,2017/05/06(21:00)
2017,05,05,110671,83028,56195,26833,47.7,2017/05/05(20:00)
2017,05,04,110671,83056,60366,22690,37.6,2017/05/04(17:00)
2017,05,03,110671,82942,58991,23951,40.6,2017/05/03(21:00)
2017,05,02,110671,82331,62100,20231,32.6,2017/05/02(17:00)
2017,05,01,110671,82501,56790,25711,45.3,2017/05/01(20:00)
2017,04,30,110671,80635,54163,26472,48.9,2017/04/30(21:00)
2017,04,29,110671,81130,55507,25623,46.2,2017/04/29(21:00)
2017,04,28,110671,80659,62861,17798,28.3,2017/04/28(17:00)
2017,04,27,110671,79714,63751,15963,25,2017/04/27(20:00)
2017,04,26,110671,80871,63329,17542,27.7,2017/04/26(11:00)
2017,04,25,110671,81209,64533,16676,25.8,2017/04/25(17:00)
2017,04,24,110671,82873,63820,19053,29.9,2017/04/24(20:00)
2017,04,23,110671,81850,54420,27430,50.4,2017/04/23(21:00)
2017,04,22,110671,83523,56424,27099,48,2017/04/22(21:00)
2017,04,21,110671,84048,63284,20764,32.8,2017/04/21(10:00)
2017,04,20,110671,83682,65335,18347,28.1,2017/04/20(15:00)
2017,04,19,110671,83051,62985,20066,31.9,2017/04/19(10:00)
2017,04,18,110671,83724,65101,18623,28.6,2017/04/18(17:00)
2017,04,17,110671,82855,66355,16500,24.9,2017/04/17(15:00)
2017,04,16,110671,82735,54282,28453,52.4,2017/04/16(21:00)
2017,04,15,110671,83099,55961,27138,48.5,2017/04/15(01:00)
2017,04,14,110502,85529,64493,21036,32.6,2017/04/14(17:00)
2017,04,13,110502,84544,64430,20114,31.2,2017/04/13(20:00)
2017,04,12,110502,85970,64262,21708,33.8,2017/04/12(20:00)
2017,04,11,110502,87343,65921,21422,32.5,2017/04/11(10:00)
2017,04,10,110502,87013,63993,23020,36,2017/04/10(20:00)
2017,04,09,110502,84126,54617,29509,54,2017/04/09(21:00)
2017,04,08,110502,86383,56759,29624,52.2,2017/04/08(10:00)
2017,04,07,110502,87253,65396,21857,33.4,2017/04/07(10:00)
2017,04,06,110502,87916,69129,18787,27.2,2017/04/06(11:00)
2017,04,05,110502,86046,68200,17846,26.2,2017/04/05(17:00)
2017,04,04,110502,86064,65973,20091,30.5,2017/04/04(10:00)
2017,04,03,110502,84021,65686,18335,27.9,2017/04/03(10:00)
2017,04,02,110502,85311,56420,28891,51.2,2017/04/02(23:00)
2017,04,01,110502,84158,59219,24939,42.1,2017/04/01(24:00)
2017,03,31,109493,88725,68976,19749,28.6,2017/03/31(10:00)
2017,03,30,109493,87994,67807,20187,29.8,2017/03/30(10:00)
2017,03,29,109493,87117,69891,17226,24.6,2017/03/29(10:00)
2017,03,28,109493,86241,70060,16181,23.1,2017/03/28(10:00)
2017,03,27,108601,88323,70135,18188,25.9,2017/03/27(10:00)
2017,03,26,108601,87877,57467,30410,52.9,2017/03/26(23:00)
2017,03,25,108601,86606,61395,25211,41.1,2017/03/25(11:00)
2017,03,24,108601,88072,69257,18815,27.2,2017/03/24(10:00)
2017,03,23,108601,87672,69549,18123,26.1,2017/03/23(10:00)
2017,03,22,108601,87657,70170,17487,24.9,2017/03/22(10:00)
2017,03,21,108601,87503,68210,19293,28.3,2017/03/21(20:00)
2017,03,20,108601,87922,69809,18113,25.9,2017/03/20(11:00)
2017,03,19,108601,87910,56890,31020,54.5,2017/03/19(23:00)
2017,03,18,108601,90013,61921,28092,45.4,2017/03/18(10:00)
2017,03,17,108601,91839,70322,21517,30.6,2017/03/17(10:00)
2017,03,16,107703,91482,70775,20707,29.3,2017/03/16(10:00)
2017,03,15,107703,90591,71134,19457,27.4,2017/03/15(10:00)
2017,03,14,107703,91119,70674,20445,28.9,2017/03/14(10:00)
2017,03,13,107703,93327,70385,22942,32.6,2017/03/13(10:00)
2017,03,12,107703,91063,57589,33474,58.1,2017/03/12(01:00)
2017,03,11,107703,90228,62468,27760,44.4,2017/03/11(01:00)
2017,03,10,107703,92047,73349,18698,25.5,2017/03/10(10:00)
2017,03,09,107703,92807,74556,18251,24.5,2017/03/09(10:00)
2017,03,08,107703,92902,76634,16268,21.2,2017/03/08(10:00)
2017,03,07,107098,93840,76756,17084,22.3,2017/03/07(10:00)
2017,03,06,107098,94148,73396,20752,28.3,2017/03/06(10:00)
2017,03,05,107098,91770,58780,32990,56.1,2017/03/05(24:00)
2017,03,04,107098,91420,62651,28769,45.9,2017/03/04(01:00)
2017,03,03,107098,93479,74262,19487,26.2,2017/03/03(10:00)
2017,03,02,107098,92979,75921,17058,22.5,2017/03/02(10:00)
2017,03,01,107098,92104,64523,27581,42.7,2017/03/01(20:00)
2017,02,28,107098,92437,73617,18820,25.6,2017/02/28(10:00)
2017,02,27,107098,93171,73564,19607,26.7,2017/02/27(10:00)
2017,02,26,107098,91375,60444,30931,51.2,2017/02/26(24:00)
2017,02,25,107098,91811,64596,27215,42.1,2017/02/25(01:00)
2017,02,24,107098,92732,75970,16762,22.1,2017/02/24(10:00)
2017,02,23,107098,93526,75909,17617,23.2,2017/02/23(10:00)
2017,02,22,107098,93689,78523,15166,19.3,2017/02/22(11:00)
2017,02,21,107098,93347,77149,16198,21,2017/02/21(10:00)
2017,02,20,107098,93928,76063,17865,23.5,2017/02/20(11:00)
2017,02,19,107098,89643,61553,28090,45.6,2017/02/19(01:00)
2017,02,18,107098,90042,65574,24468,37.3,2017/02/18(11:00)
2017,02,17,107098,96207,74358,21849,29.4,2017/02/17(10:00)
2017,02,16,107098,96295,75604,20691,27.4,2017/02/16(10:00)
2017,02,15,107098,96403,77770,18633,24,2017/02/15(10:00)
2017,02,14,107098,96561,78279,18282,23.4,2017/02/14(10:00)
2017,02,13,107098,96343,79050,17293,21.9,2017/02/13(11:00)
2017,02,12,107098,93782,64047,29735,46.4,2017/02/12(01:00)
2017,02,11,107098,92955,69363,23592,34,2017/02/11(11:00)
2017,02,10,107098,95916,81268,14648,18,2017/02/10(11:00)
2017,02,09,107098,97002,80002,17000,21.2,2017/02/09(10:00)
2017,02,08,107098,96980,79274,17706,22.3,2017/02/08(11:00)
2017,02,07,107098,97305,80163,17142,21.4,2017/02/07(10:00)
2017,02,06,107098,96366,78251,18115,23.1,2017/02/06(10:00)
2017,02,05,107098,94991,62577,32414,51.8,2017/02/05(24:00)
2017,02,04,107098,94172,67533,26639,39.4,2017/02/04(11:00)
2017,02,03,107098,96289,78232,18057,23.1,2017/02/03(10:00)
2017,02,02,107098,96341,80243,16098,20.1,2017/02/02(10:00)
2017,02,01,107098,95220,80173,15047,18.8,2017/02/01(11:00)
2017,01,31,106238,94937,77034,17903,23.2,2017/01/31(11:00)
2017,01,30,106238,91686,62634,29052,46.4,2017/01/30(24:00)
2017,01,29,106238,89100,57667,31433,54.5,2017/01/29(24:00)
2017,01,28,106238,89072,56442,32630,57.8,2017/01/28(01:00)
2017,01,27,106238,91078,62908,28170,44.8,2017/01/27(01:00)
2017,01,26,106238,95631,78670,16961,21.6,2017/01/26(10:00)
2017,01,25,106238,95823,81686,14137,17.3,2017/01/25(10:00)
2017,01,24,106238,96526,82884,13642,16.5,2017/01/24(10:00)
2017,01,23,106238,95443,83657,11786,14.1,2017/01/23(11:00)
2017,01,22,106238,91965,66749,25216,37.8,2017/01/22(24:00)
2017,01,21,106238,90927,71225,19702,27.7,2017/01/21(11:00)
2017,01,20,106238,94284,81765,12519,15.3,2017/01/20(11:00)
2017,01,19,106238,94146,80171,13975,17.4,2017/01/19(10:00)
2017,01,18,106238,95091,79959,15132,18.9,2017/01/18(10:00)
2017,01,17,105866,94280,81681,12599,15.4,2017/01/17(10:00)
2017,01,16,105866,93313,80790,12523,15.5,2017/01/16(11:00)
2017,01,15,105866,91004,66021,24983,37.8,2017/01/15(01:00)
2017,01,14,105866,92828,69894,22934,32.8,2017/01/14(11:00)
2017,01,13,105866,94912,80079,14833,18.5,2017/01/13(11:00)
2017,01,12,105866,94338,78403,15935,20.3,2017/01/12(10:00)
2017,01,11,105866,94862,78898,15964,20.2,2017/01/11(10:00)
2017,01,10,105866,93039,76690,16349,21.3,2017/01/10(10:00)
2017,01,09,105866,92252,75090,17162,22.9,2017/01/09(11:00)
2017,01,08,105866,90644,59058,31586,53.5,2017/01/08(24:00)
2017,01,07,105866,90470,64879,25591,39.4,2017/01/07(11:00)
2017,01,06,105866,92841,74060,18781,25.4,2017/01/06(10:00)
2017,01,05,105866,92474,76304,13081,17.1,2017/01/05(11:00)
2017,01,04,105866,92353,75778,16575,21.9,2017/01/04(10:00)
2017,01,03,105866,94223,75471,18752,24.8,2017/01/03(10:00)
2017,01,02,105866,92573,72901,19672,27,2017/01/02(11:00)
2017,01,01,105866,89861,59234,30627,51.7,2017/01/01(01:00)
2016,12,31,105866,82458,63693,28765,45.2,2016/12/31(01:00)
2016,12,30,105866,93773,76199,17574,23.1,2016/12/30(10:00)
2016,12,29,105866,93229,77900,15329,19.7,2016/12/29(10:00)
2016,12,28,105866,92564,77863,14701,18.9,2016/12/28(10:00)
2016,12,27,105866,92007,76864,15143,19.7,2016/12/27(10:00)
2016,12,26,105866,91610,77204,14406,18.7,2016/12/26(11:00)
2016,12,25,105866,88547,61186,27361,44.7,2016/12/25(01:00)
2016,12,24,105866,90172,66078,24094,36.5,2016/12/24(11:00)
2016,12,23,105866,90894,77048,13846,18,2016/12/23(11:00)
2016,12,22,105866,90449,73690,16759,22.7,2016/12/22(17:00)
2016,12,21,105866,89166,74306,14860,20,2016/12/21(10:00)
2016,12,20,104466,89662,74281,15381,20.7,2016/12/20(10:00)
2016,12,19,104466,91271,76506,14765,19.3,2016/12/19(11:00)
2016,12,18,104466,88826,61057,27769,45.5,2016/12/18(01:00)
2016,12,17,104466,89028,67116,21912,32.6,2016/12/17(11:00)
2016,12,16,104466,93031,79966,13065,16.3,2016/12/16(10:00)
2016,12,15,103299,92819,78945,13874,17.6,2016/12/15(10:00)
2016,12,14,103299,92681,77634,15047,19.4,2016/12/14(11:00)
2016,12,13,103299,92178,76461,15717,20.6,2016/12/13(10:00)
2016,12,12,103299,92578,77426,15152,19.6,2016/12/12(11:00)
2016,12,11,103299,87632,61800,25832,40.4,2016/12/11(24:00)
2016,12,10,103299,85209,65024,20185,31,2016/12/10(11:00)
2016,12,09,103299,91310,73993,17317,23.4,2016/12/09(10:00)
2016,12,08,103299,90628,76313,14315,18.8,2016/12/08(10:00)
2016,12,07,103299,90821,76917,13904,18.1,2016/12/07(10:00)
2016,12,06,103299,90426,74652,15774,21.1,2016/12/06(10:00)
2016,12,05,103299,87795,72596,15199,20.9,2016/12/05(10:00)
2016,12,04,103299,82341,58853,23488,39.9,2016/12/04(24:00)
2016,12,03,103299,83525,62882,20643,32.8,2016/12/03(11:00)
2016,12,02,103299,85671,73589,12082,16.4,2016/12/02(10:00)
2016,12,01,103299,86447,72598,13849,19.1,2016/12/01(18:00)
2016,11,30,103299,85024,74959,10065,13.4,2016/11/30(11:00)
2016,11,29,103299,85937,74756,11781,15.9,2016/11/29(10:00)
2016,11,28,103299,83432,73520,9912,13.5,2016/11/28(18:00)
2016,11,27,103299,75011,59455,15556,26.2,2016/11/27(24:00)
2016,11,26,103299,73620,66203,7417,11.2,2016/11/26(11:00)
2016,11,25,103299,82612,73611,9001,12.2,2016/11/25(10:00)
2016,11,24,103299,83190,74022,9168,12.4,2016/11/24(18:00)
2016,11,23,103299,83056,72066,10990,15.2,2016/11/23(10:00)
2016,11,22,103299,82141,71284,10857,15.2,2016/11/22(18:00)
2016,11,21,103299,80430,68476,11954,17.5,2016/11/21(11:00)
2016,11,20,103299,77873,55821,22052,39.5,2016/11/20(01:00)
2016,11,19,103299,77440,60212,17228,28.6,2016/11/19(11:00)
2016,11,18,103299,83566,67877,15689,23.1,2016/11/18(10:00)
2016,11,17,103299,84260,67768,16492,24.3,2016/11/17(10:00)
2016,11,16,103299,83901,68765,15136,22,2016/11/16(10:00)
2016,11,15,103299,81672,67832,13840,20.4,2016/11/15(19:00)
2016,11,14,103299,80581,66834,13747,20.6,2016/11/14(18:00)
2016,11,13,103299,76063,55217,20846,37.8,2016/11/13(19:00)
2016,11,12,103299,75429,58495,16934,28.9,2016/11/12(10:00)
2016,11,11,103299,81485,67352,14133,21,2016/11/11(10:00)
2016,11,10,103299,82444,69906,12538,17.9,2016/11/10(10:00)
2016,11,09,103299,81574,67885,13689,20.2,2016/11/09(10:00)
2016,11,08,103299,81278,68309,12969,19,2016/11/08(19:00)
2016,11,07,103299,80166,65572,14594,22.3,2016/11/07(18:00)
2016,11,06,103299,76791,55010,21781,39.6,2016/11/06(19:00)
2016,11,05,103299,74244,58041,16203,27.9,2016/11/05(11:00)
2016,11,04,103299,81469,67038,14431,20.2,2016/11/04(10:00)
2016,11,03,103299,81900,63626,13884,20.4,2016/11/03(11:00)
2016,11,02,103299,82339,68711,13628,19.8,2016/11/02(10:00)
2016,11,01,103068,82339,68949,14170,20.6,2016/11/01(19:00)
2016,10,31,103068,78563,68282,10281,15.1,2016/10/31(18:00)
2016,10,30,103068,68186,54656,13530,24.8,2016/10/30(20:00)
2016,10,29,103068,71412,58250,13162,22.6,2016/10/29(11:00)
2016,10,28,103068,78097,65408,12689,19.4,2016/10/28(11:00)
2016,10,27,103068,79533,65786,13747,20.9,2016/10/27(19:00)
2016,10,26,103068,80450,64893,15557,24,2016/10/26(19:00)
2016,10,25,103068,79305,66171,13134,19.8,2016/10/25(19:00)
2016,10,24,103068,78892,65420,13472,20.6,2016/10/24(19:00)
2016,10,23,103068,67737,54151,13586,25.1,2016/10/23(20:00)
2016,10,22,103068,68353,57118,11235,19.7,2016/10/22(11:00)
2016,10,21,103068,76471,64898,11573,17.8,2016/10/21(15:00)
2016,10,20,103068,77231,66271,10960,16.5,2016/10/20(19:00)
2016,10,19,103068,75887,65157,10730,16.5,2016/10/19(19:00)
2016,10,18,103068,76148,66241,9907,15,2016/10/18(19:00)
2016,10,17,103068,76480,65430,11050,16.9,2016/10/17(19:00)
2016,10,16,103068,66094,54441,11653,21.4,2016/10/16(19:00)
2016,10,15,103068,67045,56484,10561,18.7,2016/10/15(19:00)
2016,10,14,103068,76826,64400,12426,19.3,2016/10/14(19:00)
2016,10,13,103068,76509,65420,11089,17,2016/10/13(19:00)
2016,10,12,102018,75340,64249,11091,17.3,2016/10/12(19:00)
2016,10,11,102018,77312,65143,12169,18.7,2016/10/11(19:00)
2016,10,10,102018,77874,64320,13554,21.1,2016/10/10(19:00)
2016,10,09,102018,66322,53219,13103,24.6,2016/10/09(20:00)
2016,10,08,102018,67494,58538,8956,15.3,2016/10/08(01:00)
2016,10,07,102018,77361,66082,11279,17.1,2016/10/07(17:00)
2016,10,06,102018,77712,65864,11848,18,2016/10/06(17:00)
2016,10,05,102018,77328,66398,10930,16.5,2016/10/05(17:00)
2016,10,04,102018,77549,68076,9473,13.9,2016/10/04(17:00)
2016,10,03,102018,72367,59881,12486,20.9,2016/10/03(20:00)
2016,10,02,102018,69881,54396,15485,28.5,2016/10/02(20:00)
2016,10,01,102018,68617,57724,10893,18.9,2016/10/01(11:00)
2016,09,30,102018,81194,65346,15848,24.3,2016/09/30(15:00)
2016,09,29,101025,80189,66486,13703,20.6,2016/09/29(15:00)
2016,09,28,101025,80198,68539,11659,17,2016/09/28(15:00)
2016,09,27,101025,80158,69576,10582,15.2,2016/09/27(15:00)
2016,09,26,101025,80789,68737,12052,17.5,2016/09/26(17:00)
2016,09,25,101025,70298,55864,14434,25.8,2016/09/25(20:00)
2016,09,24,101025,70343,59413,10930,18.4,2016/09/24(15:00)
2016,09,23,101025,81421,67087,14334,21.4,2016/09/23(17:00)
2016,09,22,101025,81501,66526,14975,22.5,2016/09/22(17:00)
2016,09,21,101025,83811,65243,18568,28.5,2016/09/21(17:00)
2016,09,20,101025,84287,65571,18716,28.5,2016/09/20(17:00)
2016,09,19,101025,84281,66807,17474,26.2,2016/09/19(15:00)
2016,09,18,101025,72246,55063,17183,31.2,2016/09/18(20:00)
2016,09,17,101025,69461,52183,17278,33.1,2016/09/17(20:00)
2016,09,16,101025,70906,51254,19652,38.3,2016/09/16(20:00)
2016,09,15,101025,71121,48036,23085,48.1,2016/09/15(20:00)
2016,09,14,101025,71163,50931,20232,39.7,2016/09/14(20:00)
2016,09,13,101025,84097,67051,17046,25.4,2016/09/13(15:00)
2016,09,12,101025,87436,70245,17191,24.5,2016/09/12(15:00)
2016,09,11,101025,76541,59361,17180,28.9,2016/09/11(20:00)
2016,09,10,101025,75753,64267,11486,17.9,2016/09/10(15:00)
2016,09,09,101025,85078,72942,12136,16.6,2016/09/09(15:00)
2016,09,08,101025,85869,72779,13090,18,2016/09/08(15:00)
2016,09,07,101025,85422,74096,11326,15.3,2016/09/07(15:00)
2016,09,06,101025,85469,74763,10706,14.3,2016/09/06(15:00)
2016,09,05,101025,85109,75299,9810,13,2016/09/05(17:00)
2016,09,04,101025,73267,59979,13288,22.2,2016/09/04(20:00)
2016,09,03,101025,75346,62793,12553,20,2016/09/03(15:00)
2016,09,02,101025,88668,70674,17994,25.5,2016/09/02(15:00)
2016,09,01,101025,88838,72151,16687,23.1,2016/09/01(15:00)
2016,08,31,101025,90561,66093,24468,37,2016/08/31(17:00)
2016,08,30,100670,91280,66987,24293,36.3,2016/08/30(17:00)
2016,08,29,100670,91348,67384,24480,36.6,2016/08/29(17:00)
2016,08,28,100670,79409,55005,24404,44.4,2016/08/28(20:00)
2016,08,27,100670,80851,61325,19526,31.8,2016/08/27(15:00)
2016,08,26,100670,90970,71673,19297,26.9,2016/08/26(11:00)
2016,08,25,100670,90720,81780,8940,10.9,2016/08/25(15:00)
2016,08,24,100670,90720,81362,9358,11.5,2016/08/24(17:00)
2016,08,23,100670,90449,82564,7885,9.6,2016/08/23(15:00)
2016,08,22,100670,90425,83731,6694,8,2016/08/22(17:00)
2016,08,21,100180,79171,67470,11701,17.3,2016/08/21(20:00)
2016,08,20,100180,84910,72886,12024,16.5,2016/08/20(15:00)
2016,08,19,100180,91151,82770,8381,10.1,2016/08/19(15:00)
2016,08,18,100180,91084,83742,7342,8.8,2016/08/18(15:00)
2016,08,17,100180,91009,83296,7713,9.3,2016/08/17(15:00)
2016,08,16,100180,90967,83068,7899,9.5,2016/08/16(17:00)
2016,08,15,100180,83695,71947,11748,16.3,2016/08/15(15:00)
2016,08,14,100180,80544,67993,12551,18.5,2016/08/14(21:00)
2016,08,13,100180,83300,74429,8871,11.9,2016/08/13(15:00)
2016,08,12,100180,92395,85183,7212,8.5,2016/08/12(17:00)
2016,08,11,100180,91680,84974,6706,7.9,2016/08/11(17:00)
2016,08,10,100180,92386,83123,9263,11.1,2016/08/10(17:00)
2016,08,09,100180,91440,82724,8716,10.5,2016/08/09(15:00)
2016,08,08,100180,89608,83700,5908,7.1,2016/08/08(15:00)
2016,08,07,100180,76815,67510,9305,13.8,2016/08/07(21:00)
2016,08,06,100180,81236,71602,9634,13.5,2016/08/06(15:00)
2016,08,05,100180,88096,77573,10523,13.6,2016/08/05(15:00)
2016,08,04,100180,88410,75694,12716,16.8,2016/08/04(17:00)
2016,08,03,100180,88676,69613,19063,27.4,2016/08/03(15:00)
2016,08,02,100180,89826,68743,21083,30.7,2016/08/02(15:00)
2016,08,01,100180,89095,68944,20151,29.2,2016/08/01(15:00)
2016,07,31,100180,76193,64469,11724,18.2,2016/07/31(21:00)
2016,07,30,100180,77676,66669,11007,16.5,2016/07/30(15:00)
2016,07,29,100180,86712,76408,10304,13.5,2016/07/29(15:00)
2016,07,28,100180,89311,79547,9764,12.3,2016/07/28(15:00)
2016,07,27,100180,89712,80482,9230,11.5,2016/07/27(15:00)
2016,07,26,100180,88923,81110,7813,9.6,2016/07/26(15:00)
2016,07,25,100180,88990,80215,8775,10.9,2016/07/25(15:00)
2016,07,24,100180,76202,65790,10412,15.8,2016/07/24(21:00)
2016,07,23,100180,79141,69122,10019,14.5,2016/07/23(15:00)
2016,07,22,100180,88555,77815,10740,13.8,2016/07/22(17:00)
2016,07,21,100180,88526,76366,12160,15.9,2016/07/21(17:00)
2016,07,20,100180,88889,76667,12222,15.9,2016/07/20(15:00)
2016,07,19,100180,88635,75150,13485,17.9,2016/07/19(15:00)
2016,07,18,99878,89091,71810,17281,24.1,2016/07/18(17:00)
2016,07,17,99878,76339,57401,18938,33,2016/07/17(21:00)
2016,07,16,99878,78526,62859,15667,24.9,2016/07/16(12:00)
2016,07,15,99878,88032,74767,13265,17.7,2016/07/15(15:00)
2016,07,14,99878,87194,76203,10991,14.4,2016/07/14(15:00)
2016,07,13,99878,86944,76326,10618,13.9,2016/07/13(15:00)
2016,07,12,99878,86506,76630,9876,12.9,2016/07/12(15:00)
2016,07,11,99878,85481,78197,7284,9.3,2016/07/11(15:00)
2016,07,10,99878,73413,61203,12210,20,2016/07/10(21:00)
2016,07,09,99878,74830,66515,8315,12.5,2016/07/09(15:00)
2016,07,08,98948,84847,74997,9850,13.1,2016/07/08(15:00)
2016,07,07,98948,86068,73086,12982,17.8,2016/07/07(15:00)
2016,07,06,98948,86705,71949,14756,20.5,2016/07/06(15:00)
2016,07,05,98948,86753,72993,13760,18.9,2016/07/05(15:00)
2016,07,04,98948,85873,69487,16386,23.6,2016/07/04(15:00)
2016,07,03,98948,75199,56509,18690,33.1,2016/07/03(21:00)
2016,07,02,98948,75644,61952,13692,22.1,2016/07/02(12:00)
2016,07,01,98948,85533,72275,13258,18.3,2016/07/01(15:00)
2016,06,30,98948,83978,72528,11450,15.8,2016/06/30(15:00)
2016,06,29,98948,83457,71556,11901,16.6,2016/06/29(15:00)
2016,06,28,98948,83416,71431,11985,16.8,2016/06/28(15:00)
2016,06,27,98948,83934,70520,13414,19,2016/06/27(15:00)
2016,06,26,98948,71621,56370,15251,27.1,2016/06/26(21:00)
2016,06,25,98948,72876,59406,13470,22.7,2016/06/25(21:00)
2016,06,24,98948,82074,70325,11749,16.7,2016/06/24(15:00)
2016,06,23,98948,80956,72816,8140,11.2,2016/06/23(15:00)
2016,06,22,98948,82034,72340,9694,13.4,2016/06/22(15:00)
2016,06,21,98948,80966,72018,8948,12.4,2016/06/21(15:00)
2016,06,20,98948,80999,71333,9666,13.6,2016/06/20(15:00)
2016,06,19,98948,71404,57111,14293,25,2016/06/19(21:00)
2016,06,18,98948,70240,61326,8914,14.5,2016/06/18(15:00)
2016,06,17,98948,81941,69037,12904,18.7,2016/06/17(17:00)
2016,06,16,98948,81864,67964,13900,20.5,2016/06/16(15:00)
2016,06,15,98948,82117,68154,13963,20.5,2016/06/15(15:00)
2016,06,14,98948,80985,69628,11357,16.3,2016/06/14(15:00)
2016,06,13,98948,79589,69342,10247,14.8,2016/06/13(17:00)
2016,06,12,98948,70120,56360,13760,24.4,2016/06/12(21:00)
2016,06,11,98948,72076,61226,10850,17.7,2016/06/11(15:00)
2016,06,10,98948,79214,69908,9306,13.3,2016/06/10(15:00)
2016,06,09,98948,80280,68792,11488,16.7,2016/06/09(17:00)
2016,06,08,98948,80661,67384,13277,19.7,2016/06/08(15:00)
2016,06,07,98948,80807,66902,13905,20.8,2016/06/07(17:00)
2016,06,06,98948,72901,58231,14670,25.2,2016/06/06(15:00)
2016,06,05,98948,71323,54852,16471,30,2016/06/05(21:00)
2016,06,04,98948,71809,58332,13477,23.1,2016/06/04(12:00)
2016,06,03,98948,80650,67242,13408,19.9,2016/06/03(15:00)
2016,06,02,98948,80301,67243,13058,19.4,2016/06/02(17:00)
2016,06,01,98948,79870,66550,13320,20,2016/06/01(17:00)
2016,05,31,98948,80087,68011,12076,17.8,2016/05/31(15:00)
2016,05,30,98948,77432,67467,9965,14.8,2016/05/30(17:00)
2016,05,29,98948,71377,54762,16615,30.3,2016/05/29(21:00)
2016,05,28,98948,77748,66831,10917,16.3,2016/05/28(12:00)
2016,05,27,98948,77748,66831,10917,16.3,2016/05/27(15:00)
2016,05,26,98948,79616,66201,13415,20.3,2016/05/26(17:00)
2016,05,25,98948,78513,65014,13499,20.8,2016/05/25(17:00)
2016,05,24,98948,78445,65836,12609,19.2,2016/05/24(11:00)
2016,05,23,98948,78012,66919,11093,15.8,2016/05/23(17:00)
2016,05,22,98948,71452,54753,16699,30.5,2016/05/22(21:00)
2016,05,21,98948,72679,57439,15240,26.5,2016/05/21(21:00)
2016,05,20,98948,77682,66044,11638,17.6,2016/05/20(17:00)
2016,05,19,98948,77843,66331,11512,17.4,2016/05/19(17:00)
2016,05,18,98948,77528,64944,12584,19.4,2016/05/18(17:00)
2016,05,17,98948,77333,63763,13570,21.3,2016/05/17(17:00)
2016,05,16,98948,77734,62267,15467,24.8,2016/05/16(17:00)
2016,05,15,98948,73973,53811,20162,37.5,2016/05/15(21:00)
2016,05,14,98948,73290,55611,17679,31.8,2016/05/14(21:00)
2016,05,13,98948,79581,63059,16522,26.2,2016/05/13(17:00)
2016,05,12,98948,78180,63305,14875,23.5,2016/05/12(17:00)
2016,05,11,98948,78974,62605,16369,26.1,2016/05/11(17:00)
2016,05,10,98948,79158,64634,14524,22.5,2016/05/10(11:00)
2016,05,09,98948,77645,63579,14066,22.1,2016/05/09(17:00)
2016,05,08,98948,75249,52557,22692,43.2,2016/05/08(21:00)
2016,05,07,98948,75354,53034,22320,42.1,2016/05/07(21:00)
2016,05,06,98948,80494,57534,22960,39.9,2016/05/06(11:00)
2016,05,05,98948,78957,56793,22164,39,2016/05/05(21:00)
2016,05,04,98948,81780,60799,20981,34.5,2016/05/04(10:00)
2016,05,03,98948,81749,64682,17067,26.4,2016/05/03(11:00)
2016,05,02,98948,80915,63788,17127,26.8,2016/05/02(17:00)
2016,05,01,98948,75485,52528,22957,43.7,2016/05/01(21:00)
2016,04,30,98948,76444,54824,21620,39.4,2016/04/30(11:00)
2016,04,29,98948,80891,61635,19256,31.2,2016/04/29(11:00)
2016,04,28,98948,81850,62761,19089,30.4,2016/04/28(11:00)
2016,04,27,98948,81832,64566,17266,26.7,2016/04/27(15:00)
2016,04,26,98948,80954,63140,17814,28.2,2016/04/26(17:00)
2016,04,25,98948,81817,61770,20047,32.5,2016/04/25(20:00)
2016,04,24,98948,78123,53148,24975,47,2016/04/24(21:00)
2016,04,23,98948,78138,56709,21429,37.8,2016/04/23(11:00)
2016,04,22,98948,81163,62611,18552,29.6,2016/04/22(17:00)
2016,04,21,98948,81849,65489,16360,25,2016/04/21(11:00)
2016,04,20,98796,81465,63040,18425,29.2,2016/04/20(17:00)
2016,04,19,98796,82269,63025,19244,30.5,2016/04/19(20:00)
2016,04,18,98796,82442,63016,19426,30.8,2016/04/18(20:00)
2016,04,17,98796,76164,53629,22535,42,2016/04/17(21:00)
2016,04,16,98796,76726,56605,20121,35.3,2016/04/16(12:00)
2016,04,15,98796,84266,62730,21536,34.3,2016/04/15(10:00)
2016,04,14,98796,85256,61592,23664,38.4,2016/04/14(11:00)
2016,04,13,98796,85256,61592,23664,38.4,2016/04/13(11:00)
2016,04,12,98796,84871,63629,21242,33.4,2016/04/12(10:00)
2016,04,11,98796,84966,63842,21124,33.1,2016/04/11(20:00)
2016,04,10,98796,80722,53991,26731,49.5,2016/04/10(21:00)
2016,04,09,98796,79445,56897,22548,39.6,2016/04/09(11:00)
2016,04,08,98796,85758,64364,21394,33.2,2016/04/08(10:00)
2016,04,07,98796,86048,65765,20283,30.8,2016/04/07(10:00)
2016,04,06,98796,86168,63973,22195,34.7,2016/04/06(10:00)
2016,04,05,98796,85987,63821,22166,34.7,2016/04/05(10:00)
2016,04,04,98796,86308,64622,21686,33.6,2016/04/04(11:00)
2016,04,03,98796,80805,54758,26047,47.6,2016/04/03(23:00)
2016,04,02,98796,81090,56000,25090,44.8,2016/04/02(11:00)
2016,04,01,98796,89366,63321,26045,41.1,2016/04/01(10:00)
2016,03,31,98796,88016,65372,22644,34.6,2016/03/31(10:00)
2016,03,30,98796,88014,65286,22728,34.8,2016/03/30(10:00)
2016,03,29,98796,87122,66996,20126,30,2016/03/29(10:00)
2016,03,28,98796,87978,66453,21525,32.4,2016/03/28(10:00)
2016,03,27,98796,83309,56066,27243,48.6,2016/03/27(23:00)
2016,03,26,98796,86163,59204,26959,45.5,2016/03/26(01:00)
2016,03,25,98796,88950,67803,21147,31.2,2016/03/25(10:00)
2016,03,24,98796,88005,67411,20954,29.8,2016/03/24(10:00)
2016,03,23,98796,86797,66518,20279,30.5,2016/03/23(10:00)
2016,03,22,98796,86880,66468,20412,30.7,2016/03/22(10:00)
2016,03,21,98796,90330,65976,24354,36.9,2016/03/21(10:00)
2016,03,20,98796,85864,55692,30172,54.2,2016/03/20(23:00)
2016,03,19,98796,84259,59798,25461,43.3,2016/03/19(10:00)
2016,03,18,98796,88762,68855,19907,28.9,2016/03/18(10:00)
2016,03,17,98796,88762,68585,19591,28.6,2016/03/17(10:00)
2016,03,16,98796,85861,70048,15813,22.6,2016/03/16(10:00)
2016,03,15,98796,88001,71249,16752,23.5,2016/03/15(10:00)
2016,03,14,98796,85600,71811,13789,19.2,2016/03/14(10:00)
2016,03,13,98796,81728,58472,23256,39.8,2016/03/13(24:00)
2016,03,12,98796,80319,63026,17293,27.4,2016/03/12(11:00)
2016,03,11,98796,86383,73355,13028,17.8,2016/03/11(10:00)
2016,03,10,98796,84830,73534,11296,15.4,2016/03/10(10:00)
2016,03,09,98796,85282,73394,11888,16.2,2016/03/09(10:00)
2016,03,08,98796,84776,71496,13280,18.6,2016/03/08(11:00)
2016,03,07,98796,85296,68654,16642,24.2,2016/03/07(10:00)
2016,03,06,98796,80856,56541,24315,43,2016/03/06(23:00)
2016,03,05,98796,79847,61088,18759,30.7,2016/03/05(11:00)
2016,03,04,98796,83372,71181,12191,17.1,2016/03/04(10:00)
2016,03,03,98796,84410,73339,11071,15.1,2016/03/03(10:00)
2016,03,02,98796,85097,75697,9400,12.4,2016/03/02(10:00)
2016,03,01,98796,85747,65659,20088,30.6,2016/03/01(24:00)
2016,02,29,98796,87502,75081,12421,16.5,2016/02/29(11:00)
2016,02,28,98796,82820,60454,22366,37,2016/02/28(24:00)
2016,02,27,98190,85576,62835,22741,36.2,2016/02/27(11:00)
2016,02,26,98190,88805,74143,14662,19.8,2016/02/26(10:00)
2016,02,25,98190,89978,74692,15286,20.5,2016/02/25(10:00)
2016,02,24,98190,91005,74895,16110,21.5,2016/02/24(11:00)
2016,02,23,98190,91110,73020,18090,24.8,2016/02/23(10:00)
2016,02,22,98190,91271,75055,16216,21.6,2016/02/22(11:00)
2016,02,21,98190,86329,61244,25085,41,2016/02/21(24:00)
2016,02,20,98190,87494,63910,23584,36.9,2016/02/20(11:00)
2016,02,19,98190,90889,73525,17364,23.6,2016/02/19(11:00)
2016,02,18,98190,90451,74491,15960,21.4,2016/02/18(11:00)
2016,02,17,98190,89842,75386,14456,19.2,2016/02/17(10:00)
2016,02,16,98190,90441,77048,13393,17.4,2016/02/16(11:00)
2016,02,15,98190,90405,76750,13655,17.8,2016/02/15(11:00)
2016,02,14,98190,87554,62099,25455,41,2016/02/14(24:00)
2016,02,13,98190,85427,63690,23737,38.5,2016/02/13(11:00)
2016,02,12,98190,88403,72165,16238,22.5,2016/02/12(11:00)
2016,02,11,98190,93000,71422,21578,30.2,2016/02/11(11:00)
2016,02,10,98190,89176,58442,30734,52.6,2016/02/10(24:00)
2016,02,09,98190,86697,56144,30553,54.4,2016/02/09(24:00)
2016,02,08,98190,85210,54354,30856,56.8,2016/02/08(01:00)
2016,02,07,98190,85242,60053,25189,41.9,2016/02/07(01:00)
2016,02,06,98190,88569,64785,23784,36.7,2016/02/06(01:00)
2016,02,05,98190,93589,76775,16814,21.9,2016/02/05(10:00)
2016,02,04,98190,93417,78046,15371,19.7,2016/02/04(10:00)
2016,02,03,98190,93667,79833,12910,16.2,2016/02/03(10:00)
2016,02,02,98190,93809,80020,13789,17.2,2016/02/02(10:00)
2016,02,01,98190,93179,79041,14138,17.9,2016/02/01(11:00)
2016,01,31,98190,92631,63782,28849,45.2,2016/01/31(24:00)
2016,01,30,98190,88397,67071,21326,31.8,2016/01/30(11:00)
2016,01,29,98190,93196,78730,14466,18.4,2016/01/29(11:00)
2016,01,28,98190,93706,80274,13432,16.7,2016/01/28(11:00)
2016,01,27,98190,92222,79191,13031,16.5,2016/01/27(11:00)
2016,01,26,98190,93157,81877,11280,13.8,2016/01/26(11:00)
2016,01,25,98190,93248,82811,10437,12.6,2016/01/25(11:00)
2016,01,24,98190,92052,67807,24245,35.8,2016/01/24(24:00)
2016,01,23,98190,93437,71326,22111,31,2016/01/23(11:00)
2016,01,22,98190,94529,80802,13727,17,2016/01/22(11:00)
2016,01,21,98190,94793,82972,11821,14.2,2016/01/21(11:00)
2016,01,20,98190,94868,81861,13007,15.9,2016/01/20(11:00)
2016,01,19,98190,95511,82123,13388,16.3,2016/01/19(11:00)
2016,01,18,98190,95589,78462,17127,21.8,2016/01/18(18:00)
2016,01,17,98190,91948,61528,30420,49.4,2016/01/17(24:00)
2016,01,16,98190,90209,66852,23357,34.9,2016/01/16(11:00)
2016,01,15,97553,93817,77494,16323,21.1,2016/01/15(10:00)
2016,01,14,97533,94597,78269,16328,20.9,2016/01/14(10:00)
2016,01,13,97553,95050,78819,16231,20.6,2016/01/13(10:00)
2016,01,12,97553,95128,78291,16837,21.5,2016/01/12(10:00)
2016,01,11,97553,94970,76764,18206,23.7,2016/01/11(10:00)
2016,01,10,97553,94012,61698,32314,52.4,2016/01/10(24:00)
2016,01,09,97553,93863,66036,27827,42.1,2016/01/09(11:00)
2016,01,08,97553,93845,76982,16863,21.9,2016/01/08(10:00)
2016,01,07,97553,94730,76531,18199,23.8,2016/01/07(10:00)
2016,01,06,97553,91498,76602,14896,19.4,2016/01/06(10:00)
2016,01,05,97553,91944,76909,15035,19.5,2016/01/05(11:00)
2016,01,04,97553,91005,71516,19489,27.3,2016/01/04(10:00)
2016,01,03,97553,90033,58280,31753,54.5,2016/01/03(24:00)
2016,01,02,97553,89449,58562,30887,52.7,2016/01/02(24:00)
2016,01,01,97553,90066,59662,30404,51,2016/01/01(01:00)
2015,12,31,97649,90899,69887,21012,30.1,2015/12/31(10:00)
2015,12,30,97649,92185,74257,17928,24.1,2015/12/30(10:00)
2015,12,29,97649,92413,76087,16326,21.5,2015/12/29(10:00)
2015,12,28,97649,91740,75834,15906,21,2015/12/28(10:00)
2015,12,27,97649,89152,61544,27608,44.9,2015/12/27(24:00)
2015,12,26,97649,91013,61301,29712,48.5,2015/12/26(24:00)
2015,12,25,97649,90707,62658,28049,44.8,2015/12/25(24:00)
2015,12,24,97649,91827,72706,19121,26.3,2015/12/24(10:00)
2015,12,23,97649,90339,72896,17443,23.9,2015/12/23(10:00)
2015,12,22,97649,91101,74781,16320,21.8,2015/12/22(10:00)
2015,12,21,97649,91650,75526,16124,21.3,2015/12/21(11:00)
2015,12,20,97649,89053,60678,28375,46.8,2015/12/20(01:00)
2015,12,19,97649,88888,65145,23743,36.4,2015/12/19(11:00)
2015,12,18,97649,89191,77282,11909,15.4,2015/12/18(10:00)
2015,12,17,97649,87841,76340,11501,15.1,2015/12/17(10:00)
2015,12,16,97649,87330,73369,13961,19,2015/12/16(10:00)
2015,12,15,97649,86324,71928,14396,20,2015/12/15(10:00)
2015,12,14,97649,86639,71845,14794,20.6,2015/12/14(11:00)
2015,12,13,97649,84224,58055,26169,45.1,2015/12/13(24:00)
2015,12,12,97649,84692,61903,22789,36.8,2015/12/12(11:00)
2015,12,11,97649,86897,71554,15343,21.4,2015/12/11(10:00)
2015,12,10,97649,86861,72052,14809,20.6,2015/12/10(11:00)
2015,12,09,97649,86975,73300,13675,18.7,2015/12/09(10:00)
2015,12,08,97649,86628,73169,13459,18.4,2015/12/08(10:00)
2015,12,07,97649,86035,73760,12275,16.6,2015/12/07(10:00)
2015,12,06,97649,83940,59924,24016,40.1,2015/12/06(24:00)
2015,12,05,97649,82735,62921,19814,31.5,2015/12/05(11:00)
2015,12,04,97649,87385,74655,12730,17.1,2015/12/04(10:00)
2015,12,03,97649,87792,73871,13921,18.8,2015/12/03(11:00)
2015,12,02,97649,88032,71955,16077,22.3,2015/12/02(11:00)
2015,12,01,97649,87826,72117,15709,21.8,2015/12/01(10:00)
2015,11,30,97649,86474,70678,15796,22.3,2015/11/30(10:00)
2015,11,29,97649,76811,58656,18155,31,2015/11/29(01:00)
2015,11,28,97649,80131,63822,16309,25.6,2015/11/28(11:00)
2015,11,27,97649,87180,73965,13215,17.9,2015/11/27(11:00)
2015,11,26,97649,87156,73301,13855,18.9,2015/11/26(18:00)
2015,11,25,97649,84776,70103,14673,20.9,2015/11/25(11:00)
2015,11,24,97649,84583,67791,16792,24.8,2015/11/24(18:00)
2015,11,23,97476,83739,66940,16799,25.1,2015/11/23(18:00)
2015,11,22,97476,76676,54692,21984,40.2,2015/11/22(23:00)
2015,11,21,97476,78079,58603,19476,33.2,2015/11/21(11:00)
2015,11,20,97476,82380,65527,16853,25.7,2015/11/20(10:00)
2015,11,19,97476,82445,66358,16087,24.2,2015/11/19(18:00)
2015,11,18,97476,81932,66812,15120,22.6,2015/11/18(17:00)
2015,11,17,97476,81452,65056,16396,25.2,2015/11/17(11:00)
2015,11,16,97476,81378,65914,15464,23.5,2015/11/16(18:00)
2015,11,15,97476,75023,54480,20543,37.7,2015/11/15(23:00)
2015,11,14,97476,78775,57776,20999,36.3,2015/11/14(11:00)
2015,11,13,97476,82613,66214,16399,24.8,2015/11/13(11:00)
2015,11,12,97476,83048,64451,18597,28.9,2015/11/12(19:00)
2015,11,11,97476,81643,64221,17422,27.1,2015/11/11(10:00)
2015,11,10,97476,82102,65234,16868,25.9,2015/11/10(19:00)
2015,11,09,97476,81759,65021,16738,25.7,2015/11/09(18:00)
2015,11,08,97476,75984,54098,21895,40.5,2015/11/08(19:00)
2015,11,07,97476,76226,58830,17396,29.6,2015/11/07(12:00)
2015,11,06,97476,81267,63785,17482,27.4,2015/11/06(18:00)
2015,11,05,97476,80033,63626,16407,25.8,2015/11/05(10:00)
2015,11,04,97476,79933,64007,15926,24.9,2015/11/04(19:00)
2015,11,03,97476,80177,64524,15646,24.2,2015/11/03(19:00)
2015,11,02,97476,80407,64439,15968,24.8,2015/11/02(19:00)
2015,11,01,97476,72113,54224,17889,33,2015/11/01(19:00)
2015,10,31,97476,73327,56721,16606,29.3,2015/10/31(19:00)
2015,10,30,96828,80518,64239,16279,25.3,2015/10/30(19:00)
2015,10,29,96828,81438,64520,16918,26.2,2015/10/29(19:00)
2015,10,28,96828,80177,63356,16821,26.5,2015/10/28(19:00)
2015,10,27,96828,80026,64385,15641,24.3,2015/10/27(19:00)
2015,10,26,96828,79075,63891,15184,23.8,2015/10/26(19:00)
2015,10,25,96828,69680,52758,16922,32.1,2015/10/25(20:00)
2015,10,24,96828,70752,55946,14806,26.5,2015/10/24(11:00)
2015,10,23,96828,75294,63199,12095,19.1,2015/10/23(19:00)
2015,10,22,96828,75761,64211,11550,18,2015/10/22(19:00)
2015,10,21,96828,75341,64102,11239,17.5,2015/10/21(19:00)
2015,10,20,96828,75208,65040,10168,15.6,2015/10/20(19:00)
2015,10,19,96828,74906,64033,10873,17,2015/10/19(19:00)
2015,10,18,96828,71642,53494,18148,33.9,2015/10/18(20:00)
2015,10,17,96828,71663,56043,15620,27.9,2015/10/17(11:00)
2015,10,16,96828,74633,63790,10843,17,2015/10/16(19:00)
2015,10,15,96828,74187,64576,9611,14.9,2015/10/15(19:00)
2015,10,14,96828,73097,63625,9472,14.9,2015/10/14(01:00)
2015,10,13,96828,73167,63812,9355,14.7,2015/10/13(19:00)
2015,10,12,96828,74544,63312,11232,17.7,2015/10/12(19:00)
2015,10,11,96828,68218,52812,15406,29.2,2015/10/11(20:00)
2015,10,10,96828,69590,54244,15346,28.3,2015/10/10(19:00)
2015,10,09,96828,72391,58063,14328,24.7,2015/10/09(20:00)
2015,10,08,96828,76750,63497,13253,20.9,2015/10/08(19:00)
2015,10,07,96828,76699,64311,12388,19.3,2015/10/07(17:00)
2015,10,06,96828,78198,64572,13626,21.1,2015/10/06(19:00)
2015,10,05,96828,78704,63691,15013,23.6,2015/10/05(19:00)
2015,10,04,96828,72856,53269,19587,36.8,2015/10/04(20:00)
2015,10,03,96828,72319,55982,16337,29.2,2015/10/03(20:00)
2015,10,02,96828,80112,62303,17809,28.6,2015/10/02(19:00)
2015,10,01,96828,80604,65322,15282,23.4,2015/10/01(17:00)
2015,09,30,96828,80325,61103,19222,31.5,2015/09/30(15:00)
2015,09,29,96828,74792,52106,22686,43.5,2015/09/29(20:00)
2015,09,28,96828,71623,47846,23777,49.7,2015/09/28(20:00)
2015,09,27,96828,73331,44389,28942,65.2,2015/09/27(20:00)
2015,09,26,96828,74353,49043,25310,51.6,2015/09/26(01:00)
2015,09,25,96828,85334,62960,22374,35.5,2015/09/25(11:00)
2015,09,24,96828,82560,67067,15493,23.1,2015/09/24(17:00)
2015,09,23,96828,83887,66815,17072,25.6,2015/09/23(15:00)
2015,09,22,96828,83452,68297,15155,22.2,2015/09/22(17:00)
2015,09,21,96828,83380,67755,15625,23.1,2015/09/21(17:00)
2015,09,20,96828,73283,55707,17576,31.6,2015/09/20(20:00)
2015,09,19,96828,74695,59505,15190,25.5,2015/09/19(15:00)
2015,09,18,96828,82599,66562,16037,24.1,2015/09/18(17:00)
2015,09,17,96828,81586,66608,14978,22.5,2015/09/17(17:00)
2015,09,16,96828,82133,66232,15901,24,2015/09/16(17:00)
2015,09,15,96828,81410,66393,15017,22.6,2015/09/15(17:00)
2015,09,14,96828,81625,66672,14953,22.4,2015/09/14(17:00)
2015,09,13,96828,70323,53986,16337,30.3,2015/09/13(20:00)
2015,09,12,96828,72775,59147,13628,23,2015/09/12(11:00)
2015,09,11,96828,81573,67735,13838,20.4,2015/09/11(15:00)
2015,09,10,96828,80419,67993,12426,18.3,2015/09/10(01:00)
2015,09,09,96828,80598,67573,13025,19.3,2015/09/09(17:00)
2015,09,08,96828,82583,67206,15377,22.9,2015/09/08(17:00)
2015,09,07,96828,83216,68207,15009,22,2015/09/07(17:00)
2015,09,06,96828,74779,55172,19607,35.5,2015/09/06(20:00)
2015,09,05,96828,76266,62551,13715,21.9,2015/09/05(12:00)
2015,09,04,96828,83274,72121,11153,15.5,2015/09/04(15:00)
2015,09,03,96828,84154,71937,12217,17,2015/09/03(15:00)
2015,09,02,96828,84561,72236,12325,17.1,2015/09/02(15:00)
2015,09,01,96828,85102,72991,12111,16.6,2015/09/01(15:00)
2015,08,31,96828,87868,72639,15229,21,2015/08/31(15:00)
2015,08,30,96828,77848,57913,19935,34.4,2015/08/30(20:00)
2015,08,29,96828,77956,62100,15856,25.5,2015/08/29(15:00)
2015,08,28,96828,86244,70617,15627,22.1,2015/08/28(15:00)
2015,08,27,96828,86300,69840,16460,23.6,2015/08/27(15:00)
2015,08,26,96828,86665,67939,18726,27.6,2015/08/26(01:00)
2015,08,25,96828,86548,68423,18125,26.5,2015/08/25(11:00)
2015,08,24,96828,86169,73542,12627,17.2,2015/08/24(15:00)
2015,08,23,96828,76044,59361,16683,28.1,2015/08/23(20:00)
2015,08,22,96828,78190,64772,16410,27.6,2015/08/22(01:00)
2015,08,21,96828,87359,72231,15128,20.9,2015/08/21(15:00)
2015,08,20,96828,87278,74079,13199,17.8,2015/08/20(15:00)
2015,08,19,96828,87191,75218,11973,15.9,2015/08/19(15:00)
2015,08,18,96828,86170,75600,10570,14,2015/08/18(15:00)
2015,08,17,96828,87724,74469,13255,17.8,2015/08/17(17:00)
2015,08,16,96828,80270,59581,20689,34.7,2015/08/16(20:00)
2015,08,15,96828,81084,64512,16572,25.7,2015/08/15(15:00)
2015,08,14,96828,86408,69377,17031,24.5,2015/08/14(15:00)
2015,08,13,96828,87995,74160,13835,18.7,2015/08/13(15:00)
2015,08,12,96828,87919,73511,14408,19.6,2015/08/12(17:00)
2015,08,11,96828,87841,76028,11813,15.5,2015/08/11(15:00)
2015,08,10,96828,88000,76504,11496,15,2015/08/10(15:00)
2015,08,09,96828,79815,62661,17154,27.4,2015/08/09(21:00)
2015,08,08,96828,82097,69683,12414,17.8,2015/08/08(12:00)
2015,08,07,96828,89595,76916,12679,16.5,2015/08/07(15:00)
2015,08,06,96828,89876,75159,14717,19.6,2015/08/06(15:00)
2015,08,05,96828,90601,69924,20677,29.6,2015/08/05(17:00)
2015,08,04,96828,90475,67177,23298,34.7,2015/08/04(17:00)
2015,08,03,96828,89520,65735,23785,36.2,2015/08/03(17:00)
2015,08,02,96828,84378,60346,24032,39.8,2015/08/02(21:00)
2015,08,01,96828,83707,62162,21545,34.7,2015/08/01(15:00)
2015,07,31,96828,89766,74429,15337,20.6,2015/07/31(15:00)
2015,07,30,96828,89654,76696,12958,16.9,2015/07/30(15:00)
2015,07,29,96828,90010,74624,15386,20.6,2015/07/29(15:00)
2015,07,28,96828,89955,76179,13776,18.1,2015/07/28(15:00)
2015,07,27,96828,89481,73976,15505,21,2015/07/27(15:00)
2015,07,26,96828,80528,60454,20074,33.2,2015/07/26(21:00)
2015,07,25,96828,81887,64202,17685,27.5,2015/07/25(12:00)
2015,07,24,95681,88145,71742,16403,22.9,2015/07/24(12:00)
2015,07,23,95681,88247,75266,12981,17.2,2015/07/23(15:00)
2015,07,22,95681,89153,74740,14413,19.3,2015/07/22(15:00)
2015,07,21,95681,89942,73302,16640,22.7,2015/07/21(15:00)
2015,07,20,95681,89174,72128,17046,23.6,2015/07/20(15:00)
2015,07,19,95681,83966,57172,26794,46.9,2015/07/19(21:00)
2015,07,18,95681,85770,60151,25619,42.6,2015/07/18(15:00)
2015,07,17,95681,90868,67045,23823,35.5,2015/07/17(15:00)
2015,07,16,95681,90304,69032,21272,30.8,2015/07/16(15:00)
2015,07,15,95681,89665,73691,15974,21.7,2015/07/15(15:00)
2015,07,14,95681,89895,72249,17646,24.4,2015/07/14(15:00)
2015,07,13,95681,90691,67906,22785,33.6,2015/07/13(17:00)
2015,07,12,95681,84475,57062,27413,48,2015/07/12(21:00)
2015,07,11,95681,83597,65687,17910,27.3,2015/07/11(15:00)
2015,07,10,95681,89158,71612,17546,24.5,2015/07/10(15:00)
2015,07,09,95681,89194,69524,19670,28.3,2015/07/09(15:00)
2015,07,08,95681,90117,67481,22636,33.5,2015/07/08(15:00)
2015,07,07,95681,89693,67267,22426,33.3,2015/07/07(15:00)
2015,07,06,95681,89839,68718,21121,30.7,2015/07/06(15:00)
2015,07,05,95681,85946,54730,31216,57,2015/07/05(21:00)
2015,07,04,95681,87485,58508,28977,49.5,2015/07/04(15:00)
2015,07,03,95681,89885,67572,22313,33,2015/07/03(15:00)
2015,07,02,95681,89114,68058,21056,30.9,2015/07/02(15:00)
2015,07,01,95681,88897,67370,21527,32,2015/07/01(15:00)
2015,06,30,95681,87788,68545,19243,28.1,2015/06/30(15:00)
2015,06,29,95681,86322,69381,16941,24.4,2015/06/29(15:00)
2015,06,28,95681,80620,55007,25613,46.6,2015/06/28(21:00)
2015,06,27,95681,80748,59267,21481,36.2,2015/06/27(12:00)
2015,06,26,95681,86757,66006,20751,31.4,2015/06/26(15:00)
2015,06,25,95681,84325,68538,15787,23,2015/06/25(15:00)
2015,06,24,95681,84047,69882,14165,20.3,2015/06/24(15:00)
2015,06,23,95681,83419,69046,14373,20.8,2015/06/23(17:00)
2015,06,22,95681,83289,67716,15573,23,2015/06/22(15:00)
2015,06,21,95681,76306,54945,21361,38.9,2015/06/21(21:00)
2015,06,20,95681,78686,59363,19323,32.6,2015/06/20(12:00)
2015,06,19,95681,82650,68273,14377,21.1,2015/06/19(15:00)
2015,06,18,95681,82773,68456,14317,20.9,2015/06/18(16:00)
2015,06,17,95681,82024,68766,13258,19.3,2015/06/17(15:00)
2015,06,16,95681,82348,69508,12840,18.5,2015/06/16(16:00)
2015,06,15,95681,83188,69112,14076,20.4,2015/06/15(15:00)
2015,06,14,95681,78369,55037,23332,42.4,2015/06/14(21:00)
2015,06,13,95681,79295,60698,18597,30.6,2015/06/13(15:00)
2015,06,12,95681,82531,67843,14688,21.6,2015/06/12(17:00)
2015,06,11,95681,80871,67071,13800,20.6,2015/06/11(15:00)
2015,06,10,95681,79594,68573,11021,16.1,2015/06/10(15:00)
2015,06,09,95681,79795,66364,13431,20.2,2015/06/09(01:00)
2015,06,08,95681,79638,65474,14164,21.6,2015/06/08(17:00)
2015,06,07,95681,76856,53713,23143,43.1,2015/06/07(21:00)
2015,06,06,95681,74606,56114,18492,33,2015/06/06(15:00)
2015,06,05,95681,77774,63284,14490,22.9,2015/06/05(11:00)
2015,06,04,95681,78049,66264,11785,17.8,2015/06/04(15:00)
2015,06,03,95681,78028,65327,12701,19.4,2015/06/03(17:00)
2015,06,02,95681,79512,66172,13340,20.2,2015/06/02(15:00)
2015,06,01,95681,79227,65718,13509,20.6,2015/06/01(17:00)
2015,05,31,95681,75956,53681,22275,41.5,2015/05/31(21:00)
2015,05,30,95681,76038,58526,17512,29.9,2015/05/30(11:00)
2015,05,29,95681,76874,67107,9767,14.6,2015/05/29(15:00)
2015,05,28,95681,77532,66923,10609,15.9,2015/05/28(17:00)
2015,05,27,95681,76914,66092,10822,16.4,2015/05/27(17:00)
2015,05,26,95681,76617,65143,11474,17.6,2015/05/26(17:00)
2015,05,25,95681,73296,56379,16917,30,2015/05/25(21:00)
2015,05,24,95681,73939,51931,20590,39.6,2015/05/24(21:00)
2015,05,23,95681,72507,56701,15806,27.9,2015/05/23(12:00)
2015,05,22,95681,78663,63627,15036,23.6,2015/05/22(15:00)
2015,05,21,95681,77968,63145,14823,23.5,2015/05/21(17:00)
2015,05,20,95681,76699,62147,14552,23.4,2015/05/20(15:00)
2015,05,19,95681,76833,63092,13741,21.8,2015/05/19(17:00)
2015,05,18,95365,75638,62864,12774,20.3,2015/05/18(15:00)
2015,05,17,95365,72600,52474,20126,38.4,2015/05/17(21:00)
2015,05,16,95365,72529,56217,16312,29,2015/05/16(11:00)
2015,05,15,95365,78307,64069,14238,22.2,2015/05/15(15:00)
2015,05,14,95365,78219,63827,14392,22.5,2015/05/14(17:00)
2015,05,13,95365,78224,62025,16199,26.1,2015/05/13(17:00)
2015,05,12,95365,79682,61499,18183,29.6,2015/05/12(20:00)
2015,05,11,95365,79358,62407,16951,27.2,2015/05/11(17:00)
2015,05,10,95365,76585,52096,24489,47,2015/05/10(21:00)
2015,05,09,95365,76643,55800,20843,37.4,2015/05/09(11:00)
2015,05,08,95365,79521,62005,17516,28.2,2015/05/08(15:00)
2015,05,07,95365,78713,61489,17224,28,2015/05/07(17:00)
2015,05,06,95365,79932,61056,18876,30.9,2015/05/06(17:00)
2015,05,05,95365,78856,55179,23677,42.9,2015/05/05(21:00)
2015,05,04,95365,78474,57053,21421,37.5,2015/05/04(20:00)
2015,05,03,95365,75137,51611,23526,45.6,2015/05/03(21:00)
2015,05,02,95365,75723,53086,22637,42.6,2015/05/02(21:00)
2015,05,01,95365,78162,54959,23203,42.2,2015/05/01(21:00)
2015,04,30,95365,80456,62204,18252,29.3,2015/04/30(15:00)
2015,04,29,95365,79896,62500,17396,27.8,2015/04/29(01:00)
2015,04,28,95365,80029,62730,17299,27.6,2015/04/28(15:00)
2015,04,27,95365,80964,61897,19067,30.8,2015/04/27(17:00)
2015,04,26,95365,77061,52441,24620,46.9,2015/04/26(21:00)
2015,04,25,95365,78643,55101,23542,42.7,2015/04/25(11:00)
2015,04,24,95365,81058,61939,19119,30.9,2015/04/24(10:00)
2015,04,23,95365,81142,62522,18620,29.8,2015/04/23(10:00)
2015,04,22,95365,81554,62719,18835,30,2015/04/22(10:00)
2015,04,21,95365,81727,63196,18531,29.3,2015/04/21(10:00)
2015,04,20,95365,81806,65618,16188,24.7,2015/04/20(11:00)
2015,04,19,95365,77617,54102,23515,43.5,2015/04/19(23:00)
2015,04,18,95365,78532,56800,21732,38.3,2015/04/18(11:00)
2015,04,17,95365,82262,63104,19158,30.4,2015/04/17(10:00)
2015,04,16,95365,81764,65211,16553,25.4,2015/04/16(15:00)
2015,04,15,95365,81194,65086,16108,24.7,2015/04/15(10:00)
2015,04,14,95365,82017,65786,16231,24.7,2015/04/14(10:00)
2015,04,13,95365,80515,64956,15559,24,2015/04/13(11:00)
2015,04,12,95365,76842,54000,22842,42.3,2015/04/12(23:00)
2015,04,11,95365,80145,64409,15736,24.4,2015/04/11(10:00)
2015,04,10,95365,80145,64409,15736,24.4,2015/04/10(10:00)
2015,04,09,95365,79044,65751,13293,20.2,2015/04/09(10:00)
2015,04,08,95365,79635,66582,13053,19.6,2015/04/08(10:00)
2015,04,07,95365,80698,66436,14262,21.5,2015/04/07(10:00)
2015,04,06,95365,80882,65749,15133,23,2015/04/06(11:00)
2015,04,05,95365,77236,54596,22640,41.5,2015/04/05(23:00)
2015,04,04,95365,77017,56498,20519,36.3,2015/04/04(10:00)
2015,04,03,95365,83318,65030,18288,28.1,2015/04/03(10:00)
2015,04,02,95365,83739,64708,19031,29.4,2015/04/02(10:00)
2015,04,01,95365,85206,65584,19622,29.9,2015/04/01(11:00)
2015,03,31,95635,84751,65746,19005,28.9,2015/03/31(11:00)
2015,03,30,95365,84215,63670,20545,32.3,2015/03/30(10:00)
2015,03,29,95365,81444,54591,26853,49.2,2015/03/29(23:00)
2015,03,28,95365,81966,57762,24204,41.9,2015/03/28(10:00)
2015,03,27,95365,84373,66385,17988,27.1,2015/03/27(10:00)
2015,03,26,95365,85354,66899,18455,27.6,2015/03/26(10:00)
2015,03,25,95365,85329,67829,17500,25.8,2015/03/25(10:00)
2015,03,24,95365,84153,67669,16484,24.4,2015/03/24(10:00)
2015,03,23,94102,84643,66568,18075,27.2,2015/03/23(20:00)
2015,03,22,94102,76981,55520,21461,38.7,2015/03/22(23:00)
2015,03,21,94102,81538,57464,24074,41.9,2015/03/21(10:00)
2015,03,20,94102,83296,66148,17148,25.9,2015/03/20(10:00)
2015,03,19,94102,83965,66798,17167,25.7,2015/03/19(10:00)
2015,03,18,94102,83181,68802,14379,20.9,2015/03/18(10:00)
2015,03,17,94102,82075,68242,13833,20.3,2015/03/17(10:00)
2015,03,16,94102,81997,69413,12584,18.1,2015/03/16(10:00)
2015,03,15,94102,80077,57815,22262,38.5,2015/03/15(23:00)
2015,03,14,94102,80398,61622,18776,30.5,2015/03/14(11:00)
2015,03,13,94102,82119,71828,10291,14.3,2015/03/13(10:00)
2015,03,12,94102,83829,72718,11111,15.3,2015/03/12(10:00)
2015,03,11,94102,84174,73483,10691,14.5,2015/03/11(10:00)
2015,03,10,94102,84910,75375,9535,12.7,2015/03/10(01:00)
2015,03,09,94102,84130,70053,14077,20.1,2015/03/09(20:00)
2015,03,08,94102,80904,57792,23112,40,2015/03/08(01:00)
2015,03,07,94102,81505,62615,18890,30.2,2015/03/07(11:00)
2015,03,06,94102,85201,73317,11884,16.2,2015/03/06(10:00)
2015,03,05,94102,85795,74289,11506,15.5,2015/03/05(10:00)
2015,03,04,91402,87216,74800,11457,15.3,2015/03/04(10:00)
2015,03,03,94102,86423,74129,12294,16.6,2015/03/03(11:00)
2015,03,02,94102,87732,71982,15750,21.9,2015/03/02(10:00)
2015,03,01,94102,85648,59786,25862,43.3,2015/03/01(23:00)
2015,02,28,94102,86997,64908,22089,34,2015/02/28(11:00)
2015,02,27,94102,89400,73371,16029,21.8,2015/02/27(01:00)
2015,02,26,94102,88445,70678,17767,25.1,2015/02/26(10:00)
2015,02,25,94102,88372,71105,17267,24.3,2015/02/25(10:00)
2015,02,24,94102,88612,71195,17417,24.5,2015/02/24(10:00)
2015,02,23,94102,88324,71663,16661,23.2,2015/02/23(10:00)
2015,02,22,94102,86653,57926,28727,49.6,2015/02/22(24:00)
2015,02,21,94102,86220,54759,31461,57.5,2015/02/21(24:00)
2015,02,20,94102,85982,52756,32626,61.8,2015/02/20(24:00)
2015,02,19,94102,86270,52266,34004,65.1,2015/02/19(24:00)
2015,02,18,94102,88092,58143,29949,51.5,2015/02/18(01:00)
2015,02,17,94102,89268,69509,19759,28.4,2015/02/17(10:00)
2015,02,16,94102,89185,72707,16478,22.7,2015/02/16(11:00)
2015,02,15,94102,86990,60953,26037,42.7,2015/02/15(01:00)
2015,02,14,94102,84842,66381,18461,27.8,2015/02/14(10:00)
2015,02,13,94102,88296,75325,12971,17.2,2015/02/13(10:00)
2015,02,12,94102,88782,74263,14519,19.6,2015/02/12(10:00)
2015,02,11,94102,87281,74650,12631,16.9,2015/02/11(10:00)
2015,02,10,94102,88298,75019,13279,17.7,2015/02/10(10:00)
2015,02,09,94102,87926,78790,9136,11.6,2015/02/09(11:00)
2015,02,08,94102,86036,64160,21876,37.4,2015/02/08(24:00)
2015,02,07,94102,85284,66074,19210,29.1,2015/02/07(11:00)
2015,02,06,94102,88162,75326,12836,17,2015/02/06(10:00)
2015,02,05,94102,89353,75568,13785,18.2,2015/02/05(10:00)
2015,02,04,94102,88986,75795,13191,17.4,2015/02/04(10:00)
2015,02,03,94102,89487,76039,13448,17.7,2015/02/03(10:00)
2015,02,02,94102,89181,76071,13110,17.2,2015/02/02(11:00)
2015,02,01,94102,87725,61909,25816,41.7,2015/02/01(01:00)
2015,01,31,94102,88021,66124,21877,33.1,2015/01/31(11:00)
2015,01,30,94102,90133,75223,14910,19.8,2015/01/30(10:00)
2015,01,29,94102,90680,76407,14273,18.7,2015/01/29(10:00)
2015,01,28,94102,90033,76557,13476,17.6,2015/01/28(10:00)
2015,01,27,93201,90908,74412,14430,19.1,2015/01/27(10:00)
2015,01,26,93201,89867,73232,16635,22.7,2015/01/26(11:00)
2015,01,25,93201,90436,60041,30395,50.6,2015/01/25(01:00)
2015,01,24,93201,89975,64081,25894,40.4,2015/01/24(01:00)
2015,01,23,93201,92004,73957,18047,24.4,2015/01/23(10:00)
2015,01,22,93201,91587,73723,17864,24.2,2015/01/22(10:00)
2015,01,21,93201,91461,75544,15917,21.1,2015/01/21(11:00)
2015,01,20,93201,90433,76235,14198,18.6,2015/01/20(10:00)
2015,01,19,93201,90027,74564,15463,20.7,2015/01/19(11:00)
2015,01,18,93201,88913,62801,26112,41.6,2015/01/18(01:00)
2015,01,17,93201,88861,66531,22330,33.6,2015/01/17(11:00)
2015,01,16,92825,90210,75615,14595,19.3,2015/01/16(11:00)
2015,01,15,92825,90144,74662,15482,20.7,2015/01/15(10:00)
2015,01,14,92825,90287,76363,13924,18.2,2015/01/14(11:00)
2015,01,13,92825,91019,77150,13869,18,2015/01/13(10:00)
2015,01,12,92825,89953,76899,13054,17,2015/01/12(10:00)
2015,01,11,92825,88542,62260,26282,42.2,2015/01/11(11:00)
2015,01,10,92825,90179,66147,24032,36.3,2015/01/10(01:00)
2015,01,09,92825,90631,77107,13524,17.5,2015/01/09(11:00)
2015,01,08,92825,90501,77796,12705,16.3,2015/01/08(10:00)
2015,01,07,92825,90603,77597,13006,16.8,2015/01/07(10:00)
2015,01,06,92825,90377,74547,15830,21,2015/01/06(10:00)
2015,01,05,92825,89735,75118,14617,19.5,2015/01/05(11:00)
2015,01,04,92825,89554,61203,28826,46.3,2015/01/04(24:00)
2015,01,03,92825,89309,64079,25230,39.4,2015/01/03(11:00)
2015,01,02,92825,88904,69797,19107,27.4,2015/01/02(11:00)
2015,01,01,92825,87437,61739,25698,41.6,2015/01/01(24:00)
2014,12,31,93216,88465,71745,16720,23.3,2014/12/31(11:00)
2014,12,30,93216,87982,72542,15440,21.3,2014/12/30(10:00)
2014,12,29,93216,89334,74198,15136,20.4,2014/12/29(10:00)
2014,12,28,93216,88205,61769,26436,42.8,2014/12/28(01:00)
2014,12,27,93216,87776,65458,22318,34.1,2014/12/27(11:00)
2014,12,26,93216,88766,74911,13834,18.5,2014/12/26(10:00)
2014,12,25,93216,87476,65667,21809,33.2,2014/12/25(24:00)
2014,12,24,93216,89319,74969,14350,19.1,2014/12/24(10:00)
2014,12,23,93216,89306,77981,11325,14.5,2014/12/23(11:00)
2014,12,22,93216,90161,79156,11005,13.9,2014/12/22(11:00)
2014,12,21,93216,88419,64686,23733,36.7,2014/12/21(24:00)
2014,12,20,93216,87178,67176,20002,29.8,2014/12/20(11:00)
2014,12,19,93216,88662,79619,9043,11.4,2014/12/19(11:00)
2014,12,18,93216,90417,78892,11525,14.6,2014/12/18(11:00)
2014,12,17,93216,89357,80154,9203,11.5,2014/12/17(11:00)
2014,12,16,93216,88901,77950,10951,14,2014/12/16(18:00)
2014,12,15,93216,87284,77587,9697,12.5,2014/12/15(11:00)
2014,12,14,93216,86390,63231,23159,36.6,2014/12/14(01:00)
2014,12,13,93216,85732,66955,18777,28,2014/12/13(11:00)
2014,12,12,93216,86712,76682,10030,13.1,2014/12/12(10:00)
2014,12,11,93216,83959,74831,9128,12.2,2014/12/11(18:00)
2014,12,10,93216,83611,75726,7885,10.4,2014/12/10(10:00)
2014,12,09,93216,83546,76994,6552,8.5,2014/12/09(10:00)
2014,12,08,92845,83930,75976,7954,10.5,2014/12/08(11:00)
2014,12,07,92845,84502,62896,21606,34.4,2014/12/07(23:00)
2014,12,06,92845,85981,67124,22502,36.3,2014/12/06(11:00)
2014,12,05,92845,85235,75608,9627,12.7,2014/12/05(11:00)
2014,12,04,92845,84674,74965,9709,13,2014/12/04(11:00)
2014,12,03,92845,83524,74641,8883,11.9,2014/12/03(11:00)
2014,12,02,92845,83143,74227,8916,12,2014/12/02(18:00)
2014,12,01,92845,82383,72007,10376,14.4,2014/12/01(11:00)
2014,11,30,92845,81337,55881,25456,45.6,2014/11/30(23:00)
2014,11,29,92845,80153,58884,21269,36.1,2014/11/29(11:00)
2014,11,28,92845,80681,68433,12248,17.9,2014/11/28(11:00)
2014,11,27,92845,80577,67129,13448,20,2014/11/27(10:00)
2014,11,26,92845,81043,67069,13974,20.8,2014/11/26(10:00)
2014,11,25,92845,80149,67793,12356,18.2,2014/11/25(10:00)
2014,11,24,92845,79370,68325,11045,16.2,2014/11/24(01:00)
2014,11,23,92845,77872,56032,21840,39,2014/11/23(23:00)
2014,11,22,92845,78919,59676,19243,32.2,2014/11/22(11:00)
2014,11,21,92845,79519,67839,11680,17.2,2014/11/21(10:00)
2014,11,20,92845,79120,67975,11145,16.4,2014/11/20(10:00)
2014,11,19,92845,77899,69334,8565,12.4,2014/11/19(10:00)
2014,11,18,92845,78007,68121,9886,14.5,2014/11/18(10:00)
2014,11,17,92845,77438,67858,9580,14.1,2014/11/17(18:00)
2014,11,16,92845,77244,56052,21192,37.8,2014/11/16(23:00)
2014,11,15,92845,77458,60196,17262,28.7,2014/11/15(11:00)
2014,11,14,92845,80825,68655,12170,17.7,2014/11/14(10:00)
2014,11,13,92845,81184,69007,12177,17.6,2014/11/13(19:00)
2014,11,12,92845,81418,65941,15477,23.5,2014/11/12(19:00)
2014,11,11,92845,81339,64580,16759,26,2014/11/11(19:00)
2014,11,10,92845,79997,64539,15458,24,2014/11/10(19:00)
2014,11,09,92845,78554,54438,24116,44.3,2014/11/09(23:00)
2014,11,08,92845,79887,57532,22355,38.9,2014/11/08(11:00)
2014,11,07,92845,80844,63578,17266,27.2,2014/11/07(19:00)
2014,11,06,92094,80241,64014,16227,25.3,2014/11/06(19:00)
2014,11,05,92094,79874,63214,16660,26.4,2014/11/05(19:00)
2014,11,04,91196,78619,64057,14562,22.7,2014/11/04(19:00)
2014,11,03,91196,79110,63871,15239,23.9,2014/11/03(19:00)
2014,11,02,91196,78786,53691,25095,46.7,2014/11/02(23:00)
2014,11,01,91196,77622,56233,21389,38,2014/11/01(11:00)
2014,10,31,91196,77927,64278,13649,21.2,2014/10/31(11:00)
2014,10,30,91196,78731,64653,14078,21,2014/10/30(19:00)
2014,10,29,91196,78541,63902,14639,22.9,2014/10/29(19:00)
2014,10,28,91196,78754,64811,13943,21.5,2014/10/28(19:00)
2014,10,27,91196,77901,64128,13773,21.5,2014/10/27(19:00)
2014,10,26,91196,73546,53111,20435,38.5,2014/10/26(19:00)
2014,10,25,91196,73521,56092,17429,31.1,2014/10/25(11:00)
2014,10,24,91196,73478,63436,10042,15.8,2014/10/24(19:00)
2014,10,23,91196,75766,64120,11646,18.2,2014/10/23(19:00)
2014,10,22,91196,75905,63487,12418,19.6,2014/10/22(19:00)
2014,10,21,91196,76124,64634,11490,17.8,2014/10/21(19:00)
2014,10,20,90589,75520,64184,11336,17.7,2014/10/20(19:00)
2014,10,19,90589,74467,53074,21393,40.3,2014/10/19(20:00)
2014,10,18,90589,74637,55517,19120,34.4,2014/10/18(20:00)
2014,10,17,90589,75242,62550,12692,20.3,2014/10/17(19:00)
2014,10,16,90589,75304,63575,11729,18.4,2014/10/16(19:00)
2014,10,15,90589,74299,62626,11673,18.6,2014/10/15(19:00)
2014,10,14,90589,74374,63399,10975,17.3,2014/10/14(19:00)
2014,10,13,90589,73997,62685,10488,16.5,2014/10/13(19:00)
2014,10,12,90589,73988,52890,21098,39.9,2014/10/12(20:00)
2014,10,11,90589,73189,54877,18312,33.4,2014/10/11(19:00)
2014,10,10,90589,74379,62372,12007,19.3,2014/10/10(19:00)
2014,10,09,90589,75915,59045,16870,28.6,2014/10/09(19:00)
2014,10,08,90589,75745,61945,13800,22.3,2014/10/08(19:00)
2014,10,07,90589,75903,63184,12718,20.1,2014/10/07(19:00)
2014,10,06,90589,74429,62404,12025,19.3,2014/10/06(19:00)
2014,10,05,90589,74883,51715,23168,44.8,2014/10/05(20:00)
2014,10,04,90204,73092,53248,19844,37.3,2014/10/04(20:00)
2014,10,03,90204,74473,56747,17726,31.2,2014/10/03(20:00)
2014,10,02,90204,77070,62948,14122,22.4,2014/10/02(17:00)
2014,10,01,90204,76072,62630,13442,21.5,2014/10/01(17:00)
2014,09,30,90204,77174,63847,13327,20.9,2014/09/30(15:00)
2014,09,29,90204,75933,65058,10875,16.7,2014/09/29(15:00)
2014,09,28,90204,74242,54241,20001,36.9,2014/09/28(20:00)
2014,09,27,90204,73932,57263,16669,29.1,2014/09/27(15:00)
2014,09,26,90204,75528,64274,11254,17.5,2014/09/26(17:00)
2014,09,25,90204,76389,65682,10707,16.3,2014/09/25(17:00)
2014,09,24,90204,77455,64878,12577,19.4,2014/09/24(12:00)
2014,09,23,90204,77689,65404,12285,18.8,2014/09/23(15:00)
2014,09,22,90204,77752,65691,12061,18.4,2014/09/22(15:00)
2014,09,21,90204,74506,53797,20709,38.5,2014/09/21(20:00)
2014,09,20,90204,73655,57366,16289,28.4,2014/09/20(12:00)
2014,09,19,90204,77286,64544,12742,19.7,2014/09/19(15:00)
2014,09,18,90204,77788,64944,12844,19.8,2014/09/18(17:00)
2014,09,17,90204,78500,65050,13450,20.7,2014/09/17(15:00)
2014,09,16,90204,78001,66507,11494,17.3,2014/09/16(15:00)
2014,09,15,90204,77018,66972,10046,15,2014/09/15(17:00)
2014,09,14,90204,71949,55020,16929,30.8,2014/09/14(20:00)
2014,09,13,90204,72761,59351,13410,22.6,2014/09/13(15:00)
2014,09,12,90204,76704,65955,10749,16.3,2014/09/12(15:00)
2014,09,11,90204,77387,65262,12125,18.6,2014/09/11(17:00)
2014,09,10,90204,75569,54015,21554,39.9,2014/09/10(20:00)
2014,09,09,90204,74859,47665,27194,57.1,2014/09/09(20:00)
2014,09,08,90204,75957,44934,31023,69,2014/09/08(01:00)
2014,09,07,90204,76320,48762,27558,56.5,2014/09/07(20:00)
2014,09,06,90204,76176,55141,21035,38.1,2014/09/06(12:00)
2014,09,05,90204,81126,67144,13982,20.8,2014/09/05(15:00)
2014,09,04,90204,80684,68156,12528,13.8,2014/09/04(15:00)
2014,09,03,90204,81238,67408,13830,20.5,2014/09/03(15:00)
2014,09,02,90204,80519,67961,12558,18.5,2014/09/02(15:00)
2014,09,01,90204,81039,69406,11633,16.8,2014/09/01(15:00)
2014,08,31,90160,81746,55541,26205,47.2,2014/08/31(20:00)
2014,08,30,90160,79190,60855,18335,30.1,2014/08/30(15:00)
2014,08,29,90160,80945,68468,12477,18.2,2014/08/29(15:00)
2014,08,28,90160,81265,68404,12861,18.8,2014/08/28(15:00)
2014,08,27,90160,82142,68670,13472,19.6,2014/08/27(15:00)
2014,08,26,90160,82228,70689,11539,16.3,2014/08/26(15:00)
2014,08,25,90160,82934,69048,13886,20.1,2014/08/25(15:00)
2014,08,24,90160,80701,57285,23416,40.9,2014/08/24(20:00)
2014,08,23,90160,80035,62159,17876,28.8,2014/08/23(15:00)
2014,08,22,90160,83545,68320,15225,22.3,2014/08/22(15:00)
2014,08,21,90160,83984,68283,15701,23,2014/08/21(15:00)
2014,08,20,90160,83693,68596,15097,22,2014/08/20(15:00)
2014,08,19,90160,84008,67191,16817,25,2014/08/19(15:00)
2014,08,18,90160,83970,66232,17738,26.8,2014/08/18(15:00)
2014,08,17,90160,82577,55046,27531,50,2014/08/17(21:00)
2014,08,16,90160,81026,59837,21189,35.4,2014/08/16(15:00)
2014,08,15,90160,81731,61600,20131,32.7,2014/08/15(15:00)
2014,08,14,90160,84182,65015,19167,29.5,2014/08/14(11:00)
2014,08,13,90160,83327,68662,14665,21.4,2014/08/13(15:00)
2014,08,12,90160,83328,69977,13351,19.1,2014/08/12(15:00)
2014,08,11,90160,83859,67540,16319,24.2,2014/08/11(15:00)
2014,08,10,90160,82217,54596,27621,50.6,2014/08/10(21:00)
2014,08,09,90160,81683,59207,22476,38,2014/08/09(15:00)
2014,08,08,89435,83763,64948,18815,29,2014/08/08(15:00)
2014,08,07,89435,84813,64831,19982,30.8,2014/08/07(15:00)
2014,08,06,89435,83022,66074,16948,25.7,2014/08/06(15:00)
2014,08,05,89435,83404,65788,17616,26.8,2014/08/05(15:00)
2014,08,04,89435,82811,62294,20517,32.9,2014/08/04(15:00)
2014,08,03,89435,80592,57167,23425,41,2014/08/03(21:00)
2014,08,02,89435,80628,60964,19664,32.3,2014/08/02(12:00)
2014,08,01,89435,82655,68690,13965,20.3,2014/08/01(15:00)
2014,07,31,89435,83020,72870,10150,13.9,2014/07/31(15:00)
2014,07,30,89435,83387,72841,10546,14.5,2014/07/30(15:00)
2014,07,29,89059,84000,70243,13757,19.6,2014/07/29(15:00)
2014,07,28,88673,83501,70263,13238,18.8,2014/07/28(15:00)
2014,07,27,88673,81974,57555,24419,42.4,2014/07/27(21:00)
2014,07,26,88673,80516,63452,17064,26.9,2014/07/26(12:00)
2014,07,25,88673,84128,76054,8074,10.6,2014/07/25(15:00)
2014,07,24,88673,83670,71947,11723,16.3,2014/07/24(15:00)
2014,07,23,88673,83781,71830,11951,16.6,2014/07/23(15:00)
2014,07,22,88673,83240,73590,9650,13.1,2014/07/22(15:00)
2014,07,21,88673,82908,74839,8069,10.8,2014/07/21(15:00)
2014,07,20,88673,81360,60592,20768,34.3,2014/07/20(21:00)
2014,07,19,88673,79252,65090,14162,21.8,2014/07/19(15:00)
2014,07,18,88673,81050,71605,9445,13.2,2014/07/18(15:00)
2014,07,17,88673,80148,71498,8650,12.1,2014/07/17(15:00)
2014,07,16,88673,80324,72607,7717,10.6,2014/07/16(15:00)
2014,07,15,88673,80307,72611,7696,10.6,2014/07/15(15:00)
2014,07,14,88673,79828,72580,7248,10,2014/07/14(15:00)
2014,07,13,88673,77714,57026,20688,36.3,2014/07/13(21:00)
2014,07,12,88673,77808,63830,13978,21.9,2014/07/12(12:00)
2014,07,11,88673,79870,72310,7560,10.5,2014/07/11(15:00)
2014,07,10,88673,79522,73566,5956,8.1,2014/07/10(15:00)
2014,07,09,88673,78659,72676,5983,8.2,2014/07/09(12:00)
2014,07,08,88673,78164,70523,7641,10.8,2014/07/08(15:00)
2014,07,07,88673,77856,69831,8025,11.5,2014/07/07(15:00)
2014,07,06,88673,76422,54855,21567,39.3,2014/07/06(21:00)
2014,07,05,88673,75174,61356,13818,22.5,2014/07/05(12:00)
2014,07,04,88673,77939,68944,8995,13,2014/07/04(15:00)
2014,07,03,88673,78330,66535,11795,17.7,2014/07/03(15:00)
2014,07,02,88673,78077,70518,7559,10.7,2014/07/02(15:00)
2014,07,01,88673,77598,71029,6569,9.2,2014/07/01(15:00)
2014,06,30,87948,76831,69801,7030,10.1,2014/06/30(15:00)
2014,06,29,87948,75383,55503,19880,35.8,2014/06/29(21:00)
2014,06,28,87948,76353,61010,15343,25.1,2014/06/28(12:00)
2014,06,27,87948,77195,68262,8933,13.1,2014/06/27(17:00)
2014,06,26,87948,76473,68774,7699,11.2,2014/06/26(15:00)
2014,06,25,88148,76691,67542,9149,13.5,2014/06/25(15:00)
2014,06,24,88148,76698,66595,10103,15.2,2014/06/24(15:00)
2014,06,23,88148,76499,65547,10952,16.7,2014/06/23(15:00)
2014,06,22,88148,74948,53722,21226,39.5,2014/06/22(21:00)
2014,06,21,88148,75142,59988,15154,25.3,2014/06/21(12:00)
2014,06,20,88148,76953,67428,9525,14.1,2014/06/20(15:00)
2014,06,19,88148,76229,66800,9429,14.1,2014/06/19(15:00)
2014,06,18,88148,76405,67769,8636,12.7,2014/06/18(15:00)
2014,06,17,88548,75097,67326,7771,11.5,2014/06/17(15:00)
2014,06,16,88548,75244,66777,8467,12.7,2014/06/16(15:00)
2014,06,15,88548,74752,53962,20790,38.5,2014/06/15(21:00)
2014,06,14,88548,73253,58813,14440,24.6,2014/06/14(15:00)
2014,06,13,88548,75265,64400,10865,16.9,2014/06/13(15:00)
2014,06,12,88548,74225,64857,9368,14.4,2014/06/12(15:00)
2014,06,11,88548,74426,65006,9420,14.5,2014/06/11(15:00)
2014,06,10,87678,74552,66163,8389,12.7,2014/06/10(15:00)
2014,06,09,87678,75037,64907,10130,15.6,2014/06/09(17:00)
2014,06,08,87678,76689,52889,23800,45,2014/06/08(21:00)
2014,06,07,87678,73980,55666,18314,32.9,2014/06/07(15:00)
2014,06,06,87678,75770,58717,17053,29,2014/06/06(15:00)
2014,06,05,87678,75429,63187,12242,19.4,2014/06/05(15:00)
2014,06,04,87678,75459,61469,13990,22.8,2014/06/04(15:00)
2014,06,03,87678,74866,63465,11401,18,2014/06/03(15:00)
2014,06,02,87678,74289,64375,9914,15.4,2014/06/02(15:00)
2014,06,01,87678,73694,54570,19124,35,2014/06/01(21:00)
2014,05,31,87678,73356,60914,12442,20.4,2014/05/31(15:00)
2014,05,30,87678,74574,67424,7150,10.6,2014/05/30(15:00)
2014,05,29,87678,73156,66574,6582,9.9,2014/05/29(15:00)
2014,05,28,87678,73308,65865,7443,11.3,2014/05/28(15:00)
2014,05,27,87678,73310,64420,8890,13.8,2014/05/27(15:00)
2014,05,26,87678,73536,62708,10828,17.3,2014/05/26(17:00)
2014,05,25,87678,71114,52266,18848,36.1,2014/05/25(21:00)
2014,05,24,87678,67744,57838,9906,17.1,2014/05/24(15:00)
2014,05,23,87678,71512,63549,7963,12.5,2014/05/23(15:00)
2014,05,22,87678,71337,63560,7777,12.2,2014/05/22(17:00)
2014,05,21,87678,70695,62891,7804,12.4,2014/05/21(15:00)
2014,05,20,87678,70290,63090,7200,11.4,2014/05/20(15:00)
2014,05,19,87678,70761,62956,7805,12.4,2014/05/19(15:00)
2014,05,18,87678,69870,52446,17424,33.2,2014/05/18(21:00)
2014,05,17,87678,68032,56689,11343,20,2014/05/17(12:00)
2014,05,16,87678,69387,62471,6916,11.1,2014/05/16(15:00)
2014,05,15,87678,70522,62172,8350,13.4,2014/05/15(15:00)
2014,05,14,87678,69924,62471,7453,11.9,2014/05/14(15:00)
2014,05,13,87678,69385,62149,7236,11.6,2014/05/13(15:00)
2014,05,12,87678,69748,61216,8532,13.9,2014/05/12(15:00)
2014,05,11,87678,69755,52256,17499,33.5,2014/05/11(21:00)
2014,05,10,87678,68533,56582,11951,21.1,2014/05/10(11:00)
2014,05,09,88178,71606,60847,10759,17.7,2014/05/09(11:00)
2014,05,08,88178,72289,61820,10469,16.9,2014/05/08(11:00)
2014,05,07,88178,71722,59921,11801,19.7,2014/05/07(11:00)
2014,05,06,88178,70689,54460,16229,29.8,2014/05/06(21:00)
2014,05,05,88178,70419,52425,17994,34.3,2014/05/05(23:00)
2014,05,04,88178,70935,50506,20429,40.4,2014/05/04(23:00)
2014,05,03,88178,71128,52592,18536,35.2,2014/05/03(12:00)
2014,05,02,88178,72114,58473,13641,23.3,2014/05/02(17:00)
2014,05,01,88178,72950,55782,17168,30.8,2014/05/01(21:00)
2014,04,30,88178,73723,61294,12429,20.3,2014/04/30(15:00)
2014,04,29,88178,72233,62173,10060,16.2,2014/04/29(11:00)
2014,04,28,87858,72139,62596,9543,15.2,2014/04/28(15:00)
2014,04,27,87858,71031,52100,18931,36.3,2014/04/27(21:00)
2014,04,26,87858,69522,55806,13716,24.6,2014/04/26(11:00)
2014,04,25,87858,71743,61166,10577,17.3,2014/04/25(17:00)
2014,04,24,87858,72445,61546,10899,17.7,2014/04/24(20:00)
2014,04,23,87858,71889,60966,10923,17.9,2014/04/23(11:00)
2014,04,22,87858,72185,61699,10486,17,2014/04/22(20:00)
2014,04,21,87858,72156,61312,10844,17.7,2014/04/21(20:00)
2014,04,20,87858,70491,52591,17900,34,2014/04/20(21:00)
2014,04,19,87858,69979,57447,12532,21.8,2014/04/19(11:00)
2014,04,18,87858,71494,62898,8596,13.7,2014/04/18(11:00)
2014,04,17,87858,71273,63069,8204,13,2014/04/17(20:00)
2014,04,16,87858,69961,61956,8005,12.9,2014/04/16(15:00)
2014,04,15,87858,70170,62333,7837,12.6,2014/04/15(20:00)
2014,04,14,87858,71237,62272,8965,14.4,2014/04/14(20:00)
2014,04,13,87858,69789,53026,16763,31.6,2014/04/13(23:00)
2014,04,12,87858,69594,57820,11774,20.4,2014/04/12(11:00)
2014,04,11,87858,71742,63314,8428,13.3,2014/04/11(10:00)
2014,04,10,87858,71008,63345,7663,12.1,2014/04/10(10:00)
2014,04,09,87858,71458,63343,8115,12.8,2014/04/09(10:00)
2014,04,08,87334,70766,63010,7756,12.3,2014/04/08(20:00)
2014,04,07,87334,71203,63722,7481,11.7,2014/04/07(11:00)
2014,04,06,87334,71203,54598,16605,30.4,2014/04/06(23:00)
2014,04,05,87334,71860,57527,14333,24.9,2014/04/05(11:00)
2014,04,04,87334,71291,63757,7534,11.8,2014/04/04(11:00)
2014,04,03,87334,71900,63504,8396,13.2,2014/04/03(20:00)
2014,04,02,87734,70845,61890,8955,14.5,2014/04/02(10:00)
2014,04,01,87171,71756,62418,9338,15,2014/04/01(20:00)
2014,03,31,87171,71728,62487,9241,14.8,2014/03/31(11:00)
2014,03,30,87171,70630,53354,17276,32.4,2014/03/30(23:00)
2014,03,29,87171,72425,58164,14261,24.5,2014/03/29(11:00)
2014,03,28,87171,75753,62413,13340,21.4,2014/03/28(10:00)
2014,03,27,87171,76132,64011,12121,18.9,2014/03/27(10:00)
2014,03,26,87171,75610,64149,11461,17.9,2014/03/26(11:00)
2014,03,25,87171,76370,64482,11888,18.4,2014/03/25(11:00)
2014,03,24,87171,75622,64545,11077,17.2,2014/03/24(10:00)
2014,03,23,87171,74272,55419,18853,34,2014/03/23(23:00)
2014,03,22,87171,73432,59838,13594,22.7,2014/03/22(11:00)
2014,03,21,87171,76106,67809,8297,12.2,2014/03/21(10:00)
2014,03,20,87171,76095,67400,8695,12.9,2014/03/20(10:00)
2014,03,19,87171,75232,66737,8495,12.7,2014/03/19(11:00)
2014,03,18,87171,74496,65543,8953,13.7,2014/03/18(10:00)
2014,03,17,87171,74736,65809,8927,13.6,2014/03/17(10:00)
2014,03,16,87171,71711,55703,16008,28.7,2014/03/16(01:00)
2014,03,15,87171,70657,61734,8923,14.5,2014/03/15(11:00)
2014,03,14,87171,76111,68928,7183,10.4,2014/03/14(10:00)
2014,03,13,87171,76505,70934,5571,7.9,2014/03/13(10:00)
2014,03,12,87171,76527,70836,5691,8,2014/03/12(11:00)
2014,03,11,87171,77020,70922,6098,8.6,2014/03/11(10:00)
2014,03,10,87171,77100,71629,5471,7.6,2014/03/10(11:00)
2014,03,09,87171,75415,58998,16417,27.8,2014/03/09(24:00)
2014,03,08,87171,73455,63537,9918,15.6,2014/03/08(11:00)
2014,03,07,87171,78016,72167,5849,8.1,2014/03/07(10:00)
2014,03,06,87171,77322,71384,5938,8.3,2014/03/06(10:00)
2014,03,05,87171,76534,70162,6372,9.1,2014/03/05(10:00)
2014,03,04,87171,76876,69932,6944,9.9,2014/03/04(10:00)
2014,03,03,87171,76084,68575,7509,11,2014/03/03(10:00)
2014,03,02,87171,74695,56807,17888,31.5,2014/03/02(23:00)
2014,03,01,87171,74148,58850,15298,26,2014/03/01(23:00)
2014,02,28,87171,76274,67179,9095,13.5,2014/02/28(10:00)
2014,02,27,87171,75749,67342,8407,12.5,2014/02/27(10:00)
2014,02,26,87171,75725,69420,6305,9.1,2014/02/26(10:00)
2014,02,25,87171,76019,69583,6436,9.2,2014/02/25(10:00)
2014,02,24,87171,78232,69972,8260,11.8,2014/02/24(10:00)
2014,02,23,87171,77864,58631,19233,32.8,2014/02/23(01:00)
2014,02,22,87171,77296,62750,14546,23.2,2014/02/22(11:00)
2014,02,21,87171,79834,71428,8406,11.8,2014/02/21(10:00)
2014,02,20,87171,79510,71641,7869,11,2014/02/20(10:00)
2014,02,19,87171,80515,71872,8643,12,2014/02/19(10:00)
2014,02,18,87171,80300,71120,9180,12.9,2014/02/18(10:00)
2014,02,17,87171,80146,70900,9246,13,2014/02/17(10:00)
2014,02,16,87171,79288,58797,20491,34.9,2014/02/16(01:00)
2014,02,15,87171,79036,62944,16092,25.6,2014/02/15(11:00)
2014,02,14,87171,81774,72398,9376,13,2014/02/14(10:00)
2014,02,13,87171,81472,73371,8101,11,2014/02/13(10:00)
2014,02,12,87171,82049,73302,8747,11.9,2014/02/12(10:00)
2014,02,11,87171,82337,73982,8355,11.3,2014/02/11(10:00)
2014,02,10,87171,82249,74404,7845,10.5,2014/02/10(11:00)
2014,02,09,87171,81858,60604,21254,35.1,2014/02/09(24:00)
2014,02,08,87171,79368,65220,14148,21.7,2014/02/08(11:00)
2014,02,07,87171,81921,74297,7624,10.3,2014/02/07(10:00)
2014,02,06,87171,82873,76274,6599,8.7,2014/02/06(10:00)
2014,02,05,87171,83333,77295,6038,7.8,2014/02/05(10:00)
2014,02,04,87171,83238,75443,7795,10.3,2014/02/04(11:00)
2014,02,03,87171,81736,68620,13116,19.1,2014/02/03(11:00)
2014,02,02,87171,79950,53374,26576,49.8,2014/02/02(24:00)
2014,02,01,87171,78634,51521,27113,52.6,2014/02/01(24:00)
2014,01,31,87171,80632,51068,29564,57.9,2014/01/31(24:00)
2014,01,30,87171,81281,56440,24841,44,2014/01/30(01:00)
2014,01,29,87171,82244,69659,12585,18.1,2014/01/29(10:00)
2014,01,28,87171,83139,71539,11600,16.2,2014/01/28(10:00)
2014,01,27,87171,83213,73444,9769,13.3,2014/01/27(10:00)
2014,01,26,86969,81313,61182,20131,32.9,2014/01/26(24:00)
2014,01,25,86969,79201,64359,14842,23.1,2014/01/25(11:00)
2014,01,24,86969,82780,73391,9389,12.8,2014/01/24(10:00)
2014,01,23,86969,83135,75362,7773,10.3,2014/01/23(10:00)
2014,01,22,86969,84077,76306,7771,10.2,2014/01/22(10:00)
2014,01,21,86969,84080,76751,7329,9.5,2014/01/21(11:00)
2014,01,20,86969,83514,75282,8232,10.9,2014/01/20(11:00)
2014,01,19,86969,82786,62682,20104,32.1,2014/01/19(01:00)
2014,01,18,86969,82802,66275,16527,24.9,2014/01/18(11:00)
2014,01,17,86969,83911,75359,8552,11.3,2014/01/17(10:00)
2014,01,16,86969,82300,75473,6827,9,2014/01/16(11:00)
2014,01,15,86969,83690,75939,7751,10.2,2014/01/15(10:00)
2014,01,14,86969,83755,76442,7313,9.6,2014/01/14(10:00)
2014,01,13,86969,83484,76173,7311,9.6,2014/01/13(11:00)
2014,01,12,86969,83318,62125,21193,34.1,2014/01/12(24:00)
2014,01,11,86969,80527,65783,14744,22.4,2014/01/11(11:00)
2014,01,10,86969,82348,76389,5959,7.8,2014/01/10(11:00)
2014,01,09,86969,82525,75555,6970,9.2,2014/01/09(10:00)
2014,01,08,86969,82226,73029,9197,12.6,2014/01/08(11:00)
2014,01,07,86969,82224,73338,8886,12.1,2014/01/07(10:00)
2014,01,06,86969,81904,72948,8956,12.3,2014/01/06(10:00)
2014,01,05,86969,80595,59580,21015,35.3,2014/01/05(24:00)
2014,01,04,86969,79898,62599,17299,27.6,2014/01/04(11:00)
2014,01,03,86969,81239,71195,10044,14.1,2014/01/03(10:00)
2014,01,02,86969,81121,68868,12253,17.8,2014/01/02(11:00)
2014,01,01,86969,80957,57526,23431,40.7,2014/01/01(01:00)
2013,12,31,86969,81536,67916,13620,20.1,2013/12/31(10:00)
2013,12,30,86969,81472,71415,10057,14.1,2013/12/30(11:00)
2013,12,29,86969,80266,61896,18370,29.7,2013/12/29(01:00)
2013,12,28,86969,79283,65478,13805,21.1,2013/12/28(11:00)
2013,12,27,86969,81129,74675,6454,8.6,2013/12/27(11:00)
2013,12,26,86969,80779,73961,6818,9.2,2013/12/26(11:00)
2013,12,25,86969,80803,63668,17135,26.9,2013/12/25(01:00)
2013,12,24,86969,80597,74501,6096,8.2,2013/12/24(10:00)
2013,12,23,86969,81008,73629,7379,10,2013/12/23(11:00)
2013,12,22,86969,79413,61367,18046,29.4,2013/12/22(01:00)
2013,12,21,86969,78851,65438,13413,20.5,2013/12/21(11:00)
2013,12,20,86969,81588,74935,6653,8.9,2013/12/20(11:00)
2013,12,19,86969,80810,74118,6692,9,2013/12/19(11:00)
2013,12,18,86969,81117,72991,8126,11.1,2013/12/18(10:00)
2013,12,17,86969,81295,75108,6187,8.2,2013/12/17(11:00)
2013,12,16,86969,81270,75681,5589,7.4,2013/12/16(11:00)
2013,12,15,86969,78766,60957,17809,29.2,2013/12/15(24:00)
2013,12,14,86969,76972,64733,12239,18.9,2013/12/14(11:00)
2013,12,13,86969,80780,73917,6863,9.3,2013/12/13(11:00)
2013,12,12,86969,81256,72898,8358,11.5,2013/12/12(10:00)
2013,12,11,86969,81996,71706,10290,14.4,2013/12/11(11:00)
2013,12,10,86969,81637,70932,10705,15.1,2013/12/10(10:00)
2013,12,09,86969,80918,71012,9906,13.9,2013/12/09(11:00)
2013,12,08,86969,76979,57802,19177,33.2,2013/12/08(01:00)
2013,12,07,86969,76325,61430,14895,24.2,2013/12/07(11:00)
2013,12,06,86969,79746,69939,9807,14,2013/12/06(10:00)
2013,12,05,86969,78674,69964,8710,12.4,2013/12/05(10:00)
2013,12,04,86969,78920,70241,8679,12.4,2013/12/04(10:00)
2013,12,03,86969,79492,69642,9850,14.1,2013/12/03(10:00)
2013,12,02,86969,78710,69941,8769,12.5,2013/12/02(11:00)
2013,12,01,86969,76293,57856,18437,31.9,2013/12/01(24:00)
2013,11,30,86969,75919,62184,13735,22.1,2013/11/30(11:00)
2013,11,29,86333,79653,72472,7181,9.9,2013/11/29(10:00)
2013,11,28,86333,78870,72686,6184,8.5,2013/11/28(10:00)
2013,11,27,86333,77168,71192,5976,8.4,2013/11/27(11:00)
2013,11,26,86333,77306,69943,7363,10.5,2013/11/26(10:00)
2013,11,25,86333,77044,69053,7991,11.6,2013/11/25(18:00)
2013,11,24,86333,74793,56221,18572,33,2013/11/24(01:00)
2013,11,23,86333,73671,60420,13251,21.9,2013/11/23(11:00)
2013,11,22,86333,76138,68915,7223,10.5,2013/11/22(10:00)
2013,11,21,86333,76001,69400,6601,9.5,2013/11/21(10:00)
2013,11,20,86333,76239,69837,6402,9.2,2013/11/20(10:00)
2013,11,19,86333,74992,69483,5509,7.9,2013/11/19(18:00)
2013,11,18,86333,74742,69316,5426,7.8,2013/11/18(18:00)
2013,11,17,86333,71737,56018,15719,28.1,2013/11/17(23:00)
2013,11,16,86333,70621,58986,11635,19.7,2013/11/16(11:00)
2013,11,15,86333,74331,65666,8665,13.2,2013/11/15(10:00)
2013,11,14,86333,73819,67082,6737,10,2013/11/14(11:00)
2013,11,13,86333,73794,66150,7644,11.6,2013/11/13(10:00)
2013,11,12,86333,74155,66426,7729,11.6,2013/11/12(19:00)
2013,11,11,86333,73963,65865,8098,12.3,2013/11/11(19:00)
2013,11,10,86333,69772,54144,15628,28.9,2013/11/10(23:00)
2013,11,09,86333,68364,55968,12396,22.1,2013/11/09(11:00)
2013,11,08,86333,72084,62796,9288,14.8,2013/11/08(19:00)
2013,11,07,86333,71593,62671,8922,14.2,2013/11/07(19:00)
2013,11,06,86333,71457,62657,8800,14,2013/11/06(17:00)
2013,11,05,86333,70899,62668,8231,13.1,2013/11/05(19:00)
2013,11,04,86333,71064,62623,8441,13.5,2013/11/04(19:00)
2013,11,03,86333,68532,52359,16173,30.9,2013/11/03(23:00)
2013,11,02,86333,67924,55557,12367,22.3,2013/11/02(12:00)
2013,11,01,86333,69404,61066,8338,13.7,2013/11/01(19:00)
2013,10,31,86333,69799,63329,6470,10.2,2013/10/31(19:00)
2013,10,30,86333,70201,62824,7377,11.7,2013/10/30(19:00)
2013,10,29,86333,70005,63926,6079,9.5,2013/10/29(19:00)
2013,10,28,86333,69356,63155,6201,9.8,2013/10/28(19:00)
2013,10,27,86333,68172,51788,16384,31.6,2013/10/27(20:00)
2013,10,26,86333,66414,54801,11613,21.2,2013/10/26(11:00)
2013,10,25,86333,70573,62398,8175,13.1,2013/10/25(19:00)
2013,10,24,86333,69665,62777,6888,11,2013/10/24(19:00)
2013,10,23,86333,68986,62185,6801,10.9,2013/10/23(19:00)
2013,10,22,86333,68757,62822,5935,9.4,2013/10/22(19:00)
2013,10,21,86333,68004,62099,5905,9.5,2013/10/21(19:00)
2013,10,20,86333,65914,51487,14427,28,2013/10/20(20:00)
2013,10,19,86333,66713,55528,11185,20.1,2013/10/19(11:00)
2013,10,18,86333,67720,61911,5809,9.4,2013/10/18(19:00)
2013,10,17,86333,68582,62394,6188,9.9,2013/10/17(19:00)
2013,10,16,86333,69098,61498,7600,12.4,2013/10/16(19:00)
2013,10,15,86333,68613,62574,6039,9.7,2013/10/15(19:00)
2013,10,14,86333,68567,62685,5882,9.4,2013/10/14(19:00)
2013,10,13,86333,66754,51494,15260,29.6,2013/10/13(20:00)
2013,10,12,86333,66960,54568,12392,22.7,2013/10/12(12:00)
2013,10,11,86333,69410,62118,7292,11.7,2013/10/11(11:00)
2013,10,10,86333,69784,64136,5648,8.8,2013/10/10(19:00)
2013,10,09,86333,68974,59766,9208,15.4,2013/10/09(15:00)
2013,10,08,86333,69879,64075,5804,9.1,2013/10/08(11:00)
2013,10,07,86136,70074,64911,5163,8,2013/10/07(19:00)
2013,10,06,86136,68695,53017,15678,29.6,2013/10/06(20:00)
2013,10,05,86136,67497,55667,11830,21.3,2013/10/05(12:00)
2013,10,04,86136,68324,61182,7142,11.7,2013/10/04(19:00)
2013,10,03,86136,68693,57222,10971,19,2013/10/03(20:00)
2013,10,02,86136,68092,62685,5407,8.6,2013/10/02(11:00)
2013,10,01,86136,68888,63532,5356,8.4,2013/10/01(19:00)
2013,09,30,86136,69875,62764,7111,11.3,2013/09/30(17:00)
2013,09,29,86136,69052,52725,16327,31,2013/09/29(20:00)
2013,09,28,86136,67081,56668,10413,18.4,2013/09/28(11:00)
2013,09,27,86136,70742,61263,9479,15.5,2013/09/27(15:00)
2013,09,26,86136,71963,61708,10255,16.6,2013/09/26(20:00)
2013,09,25,86136,72891,63041,9850,15.6,2013/09/25(15:00)
2013,09,24,86136,72355,65765,6590,10,2013/09/24(15:00)
2013,09,23,86136,71411,64919,6492,10,2013/09/23(15:00)
2013,09,22,86136,71154,52637,18517,35.2,2013/09/22(20:00)
2013,09,21,86136,71001,50913,20088,39.5,2013/09/21(20:00)
2013,09,20,86136,72540,47235,25305,53.6,2013/09/20(20:00)
2013,09,19,86136,73168,44095,29073,65.9,2013/09/19(20:00)
2013,09,18,86136,72932,47703,25229,52.9,2013/09/18(20:00)
2013,09,17,86136,77346,60397,16949,28.1,2013/09/17(12:00)
2013,09,16,86136,76219,62839,13380,21.3,2013/09/16(15:00)
2013,09,15,86136,75124,55438,19686,35.5,2013/09/15(20:00)
2013,09,14,86136,73123,61174,11949,19.5,2013/09/14(12:00)
2013,09,13,86136,76337,67689,8648,12.8,2013/09/13(15:00)
2013,09,12,86136,76263,66213,10050,15.2,2013/09/12(17:00)
2013,09,11,86136,76738,66061,10677,16.2,2013/09/11(17:00)
2013,09,10,86136,76594,65504,11090,16.9,2013/09/10(17:00)
2013,09,09,86136,75557,65106,10451,16.1,2013/09/09(15:00)
2013,09,08,86136,73747,53099,20648,38.9,2013/09/08(20:00)
2013,09,07,86136,74006,57341,16665,29.1,2013/09/07(15:00)
2013,09,06,86136,77824,62697,15127,24.1,2013/09/06(11:00)
2013,09,05,86136,77473,63323,14150,22.3,2013/09/05(15:00)
2013,09,04,86136,77502,64303,13199,20.5,2013/09/04(17:00)
2013,09,03,86136,76614,63488,13126,20.7,2013/09/03(11:00)
2013,09,02,86136,76908,65238,11670,17.9,2013/09/02(15:00)
2013,09,01,86136,73229,54172,19057,35.2,2013/09/01(20:00)
2013,08,31,86136,72611,59493,13118,22,2013/08/31(15:00)
2013,08,30,86136,75588,68095,7493,11,2013/08/30(15:00)
2013,08,29,86136,75951,69623,6328,9.1,2013/08/29(12:00)
2013,08,28,86136,76429,69475,6954,10,2013/08/28(15:00)
2013,08,27,86136,77414,69286,8128,11.7,2013/08/27(15:00)
2013,08,26,86136,77747,69003,8744,12.7,2013/08/26(15:00)
2013,08,25,86136,75963,56316,19647,34.9,2013/08/25(21:00)
2013,08,24,86136,74834,63061,11773,18.7,2013/08/24(12:00)
2013,08,23,86136,77072,70527,6545,9.3,2013/08/23(12:00)
2013,08,22,86136,77631,73657,3974,5.4,2013/08/22(15:00)
2013,08,21,86136,76982,73266,3716,5.1,2013/08/21(15:00)
2013,08,20,86136,77908,73315,4593,6.3,2013/08/20(15:00)
2013,08,19,86136,78734,74015,4719,6.4,2013/08/19(15:00)
2013,08,18,85516,76922,62710,14212,22.7,2013/08/18(21:00)
2013,08,17,85516,75968,67118,8850,13.2,2013/08/17(15:00)
2013,08,16,85516,78167,73216,4951,6.8,2013/08/16(12:00)
2013,08,15,85516,77233,69027,8206,11.9,2013/08/15(15:00)
2013,08,14,85516,77778,72501,5277,7.3,2013/08/14(12:00)
2013,08,13,85516,77039,72615,4424,6.1,2013/08/13(15:00)
2013,08,12,85516,77413,73302,4111,5.6,2013/08/12(12:00)
2013,08,11,85516,74960,62837,12123,19.3,2013/08/11(21:00)
2013,08,10,85516,75710,67476,8234,12.2,2013/08/10(12:00)
2013,08,09,85516,78046,73600,4446,6,2013/08/09(15:00)
2013,08,08,85516,78056,73819,4237,5.7,2013/08/08(17:00)
2013,08,07,85516,77831,71825,6006,8.4,2013/08/07(15:00)
2013,08,06,85516,77895,68852,9043,13.1,2013/08/06(12:00)
2013,08,05,85516,77532,67856,9676,14.3,2013/08/05(15:00)
2013,08,04,85516,74017,58813,15204,25.9,2013/08/04(21:00)
2013,08,03,85516,73083,59182,13901,23.5,2013/08/03(14:00)
2013,08,02,85516,75609,62649,12960,20.7,2013/08/02(15:00)
2013,08,01,85516,76416,63959,12457,19.5,2013/08/01(15:00)
2013,07,31,85516,77465,65764,11701,17.8,2013/07/31(15:00)
2013,07,30,85516,77429,67939,9490,14,2013/07/30(15:00)
2013,07,29,85516,77106,68634,8472,12.3,2013/07/29(15:00)
2013,07,28,85358,75479,58219,17260,29.6,2013/07/28(21:00)
2013,07,27,85358,75708,62688,13020,20.8,2013/07/27(12:00)
2013,07,26,85358,77440,70324,7116,10.1,2013/07/26(15:00)
2013,07,25,85358,77766,69868,7898,11.3,2013/07/25(15:00)
2013,07,24,85358,78156,69230,8926,12.9,2013/07/24(15:00)
2013,07,23,85358,78240,70119,8121,11.6,2013/07/23(11:00)
2013,07,22,85358,78357,71648,6709,9.4,2013/07/22(15:00)
2013,07,21,85358,74678,59289,15389,26,2013/07/21(21:00)
2013,07,20,85358,74576,64473,10103,15.7,2013/07/20(12:00)
2013,07,19,85358,76473,72112,4361,6,2013/07/19(15:00)
2013,07,18,85358,76557,71257,5300,7.4,2013/07/18(15:00)
2013,07,17,85358,76169,70143,6026,8.6,2013/07/17(15:00)
2013,07,16,85358,76548,71529,5019,7,2013/07/16(15:00)
2013,07,15,84862,76298,71101,5197,7.3,2013/07/15(15:00)
2013,07,14,84862,73490,56534,16956,30,2013/07/14(21:00)
2013,07,13,84862,72952,62633,10319,16.5,2013/07/13(12:00)
2013,07,12,84862,75197,69699,5498,7.9,2013/07/12(15:00)
2013,07,11,84862,74699,70155,4544,6.5,2013/07/11(15:00)
2013,07,10,84862,74663,69934,4729,6.8,2013/07/10(15:00)
2013,07,09,84862,74321,69627,4694,6.7,2013/07/09(15:00)
2013,07,08,84371,74535,68800,5735,8.3,2013/07/08(15:00)
2013,07,07,84371,70878,55795,15083,27,2013/07/07(21:00)
2013,07,06,84371,71257,61321,9936,16.2,2013/07/06(15:00)
2013,07,05,84371,75373,68039,7334,10.8,2013/07/05(15:00)
2013,07,04,84371,75116,69137,5979,8.6,2013/07/04(15:00)
2013,07,03,84371,75380,69222,6158,8.9,2013/07/03(15:00)
2013,07,02,84371,75086,69401,5685,8.2,2013/07/02(15:00)
2013,07,01,84371,74572,68943,5629,8.2,2013/07/01(17:00)
2013,06,30,84371,71912,55838,16074,28.8,2013/06/30(21:00)
2013,06,29,84371,71110,60959,10151,16.7,2013/06/29(15:00)
2013,06,28,83749,74174,68422,5752,8.4,2013/06/28(15:00)
2013,06,27,83749,73565,68472,5093,7.4,2013/06/27(15:00)
2013,06,26,83749,73582,67914,5668,8.3,2013/06/26(15:00)
2013,06,25,83749,73751,67878,5873,8.7,2013/06/25(15:00)
2013,06,24,83749,72501,67212,5289,7.9,2013/06/24(15:00)
2013,06,23,83749,68226,52918,15308,28.9,2013/06/23(21:00)
2013,06,22,83749,68979,60744,8235,13.6,2013/06/22(12:00)
2013,06,21,83749,71563,67030,4533,6.8,2013/06/21(12:00)
2013,06,20,83749,72028,67488,4540,6.7,2013/06/20(15:00)
2013,06,19,83749,71872,67156,4716,7,2013/06/19(17:00)
2013,06,18,83749,72031,66929,5102,7.6,2013/06/18(15:00)
2013,06,17,83749,70892,66566,4326,6.5,2013/06/17(15:00)
2013,06,16,83749,66461,53717,12744,23.7,2013/06/16(21:00)
2013,06,15,83749,67663,60427,7236,12,2013/06/15(15:00)
2013,06,14,83749,71209,66475,4734,7.1,2013/06/14(15:00)
2013,06,13,83749,71175,66272,4903,7.4,2013/06/13(15:00)
2013,06,12,83749,70426,64819,5607,8.7,2013/06/12(15:00)
2013,06,11,83749,71426,65850,5576,8.5,2013/06/11(15:00)
2013,06,10,83749,70725,66076,4649,7,2013/06/10(15:00)
2013,06,09,83749,64713,53036,11677,22,2013/06/09(21:00)
2013,06,08,83749,65731,58352,7379,12.6,2013/06/08(12:00)
2013,06,07,83749,67653,63441,4212,6.6,2013/06/07(15:00)
2013,06,06,83749,66583,60606,5977,9.9,2013/06/06(15:00)
2013,06,05,83749,68200,63384,4816,7.6,2013/06/05(15:00)
2013,06,04,83749,67392,63185,4207,6.7,2013/06/04(17:00)
2013,06,03,83749,66890,62596,4294,6.9,2013/06/03(15:00)
2013,06,02,83749,66090,51697,14393,27.8,2013/06/02(21:00)
2013,06,01,83749,64898,55168,9730,17.6,2013/06/01(12:00)
2013,05,31,83749,67329,61677,5652,9.2,2013/05/31(15:00)
2013,05,30,83749,67127,61737,5390,8.7,2013/05/30(15:00)
2013,05,29,83465,67831,62090,5741,9.2,2013/05/29(15:00)
2013,05,28,83465,68910,63029,5881,9.3,2013/05/28(15:00)
2013,05,27,83465,69104,62576,6528,10.4,2013/05/27(17:00)
2013,05,26,83465,67381,51923,15458,29.8,2013/05/26(21:00)
2013,05,25,83465,65422,57270,8152,14.2,2013/05/25(15:00)
2013,05,24,83465,67100,61928,5172,8.4,2013/05/24(15:00)
2013,05,23,83465,66527,61462,5065,8.2,2013/05/23(15:00)
2013,05,22,83465,66430,60558,5872,9.7,2013/05/22(15:00)
2013,05,21,83465,65171,59595,5576,9.4,2013/05/21(15:00)
2013,05,20,83465,65318,59795,5523,9.2,2013/05/20(11:00)
2013,05,19,83465,62765,50511,12254,24.3,2013/05/19(21:00)
2013,05,18,83465,61758,52401,9357,17.9,2013/05/18(21:00)
2013,05,17,83465,62517,54382,8135,15,2013/05/17(21:00)
2013,05,16,83465,65686,60111,5575,9.3,2013/05/16(11:00)
2013,05,15,83465,66135,61018,5117,8.4,2013/05/15(15:00)
2013,05,14,83465,66013,60873,5140,8.4,2013/05/14(17:00)
2013,05,13,83465,66246,60757,5489,9,2013/05/13(15:00)
2013,05,12,83465,64118,50776,13342,26.3,2013/05/12(21:00)
2013,05,11,83465,64747,53938,10809,20,2013/05/11(11:00)
2013,05,10,83465,66336,60692,5644,9.3,2013/05/10(11:00)
2013,05,09,83465,66088,60325,5763,9.6,2013/05/09(15:00)
2013,05,08,83465,65576,59488,6088,10.2,2013/05/08(15:00)
2013,05,07,83465,65103,59475,5628,9.5,2013/05/07(17:00)
2013,05,06,83465,65206,58827,6379,10.8,2013/05/06(21:00)
2013,05,05,83465,65175,50753,14422,28.4,2013/05/05(23:00)
2013,05,04,83465,63404,53102,10302,19.4,2013/05/04(11:00)
2013,05,03,83465,65398,59617,5781,9.7,2013/05/03(11:00)
2013,05,02,83465,65971,59465,6506,10.9,2013/05/02(20:00)
2013,05,01,83465,65950,54401,11549,21.2,2013/05/01(21:00)
2013,04,30,83465,65965,59710,6255,10.5,2013/04/30(10:00)
2013,04,29,83465,65917,60584,5333,8.8,2013/04/29(11:00)
2013,04,28,83465,63511,51398,12113,23.6,2013/04/28(23:00)
2013,04,27,83465,64207,54274,9933,18.3,2013/04/27(23:00)
2013,04,26,83465,66289,60659,5630,9.3,2013/04/26(11:00)
2013,04,25,83465,66451,61275,5176,8.4,2013/04/25(20:00)
2013,04,24,83465,65433,59889,5544,9.3,2013/04/24(20:00)
2013,04,23,83465,66528,62169,4359,7,2013/04/23(17:00)
2013,04,22,83465,66051,60892,5159,8.5,2013/04/22(11:00)
2013,04,21,83465,64851,53250,11601,21.8,2013/04/21(23:00)
2013,04,20,83465,64731,58619,6112,10.4,2013/04/20(11:00)
2013,04,19,83465,67906,61310,6596,10.8,2013/04/19(11:00)
2013,04,18,83465,67381,61778,5603,9.1,2013/04/18(11:00)
2013,04,17,83465,67742,62189,5553,8.9,2013/04/17(11:00)
2013,04,16,83295,68267,61632,6635,10.8,2013/04/16(11:00)
2013,04,15,83295,68457,63318,5139,8.1,2013/04/15(11:00)
2013,04,14,83295,66093,53790,12303,22.9,2013/04/14(23:00)
2013,04,13,83295,67062,56491,10571,18.7,2013/04/13(01:00)
2013,04,12,83295,69195,63704,5491,8.6,2013/04/12(11:00)
2013,04,11,83295,69737,64092,5645,8.8,2013/04/11(11:00)
2013,04,10,83295,69345,64054,5291,8.3,2013/04/10(11:00)
2013,04,09,83295,69454,64098,5356,8.4,2013/04/09(20:00)
2013,04,08,83295,69370,63306,6064,9.6,2013/04/08(11:00)
2013,04,07,83295,68867,54491,14376,26.4,2013/04/07(23:00)
2013,04,06,83295,68732,57295,11437,20,2013/04/06(12:00)
2013,04,05,83295,69187,60601,8586,14.2,2013/04/05(11:00)
2013,04,04,83295,69894,62740,7154,11.4,2013/04/04(10:00)
2013,04,03,83295,69889,63906,5983,9.4,2013/04/03(10:00)
2013,04,02,83295,70225,64872,5353,8.3,2013/04/02(10:00)
2013,04,01,83295,69997,63611,6386,10,2013/04/01(11:00)
2013,03,31,83295,70153,54007,16146,29.9,2013/03/31(23:00)
2013,03,30,83295,68269,56973,11296,19.8,2013/03/30(11:00)
2013,03,29,83295,71644,63768,7876,12.4,2013/03/29(10:00)
2013,03,28,83295,71507,63891,7616,11.9,2013/03/28(10:00)
2013,03,27,83295,71498,64627,6871,10.6,2013/03/27(10:00)
2013,03,26,83295,72349,66106,6243,9.4,2013/03/26(10:00)
2013,03,25,83295,72352,65718,6634,10.1,2013/03/25(11:00)
2013,03,24,83295,71357,54589,16768,30.7,2013/03/24(23:00)
2013,03,23,83295,69949,58514,11435,19.5,2013/03/23(11:00)
2013,03,22,83295,74743,66964,7779,11.6,2013/03/22(11:00)
2013,03,21,82520,74117,67159,6958,10.4,2013/03/21(10:00)
2013,03,20,82520,73897,65952,7945,12,2013/03/20(11:00)
2013,03,19,82520,73645,64275,9370,14.6,2013/03/19(10:00)
2013,03,18,82520,73647,64038,9609,15,2013/03/18(11:00)
2013,03,17,82520,69967,54585,15382,28.2,2013/03/17(23:00)
2013,03,16,82520,71062,58869,12193,20.7,2013/03/16(11:00)
2013,03,15,82520,74939,66752,8187,12.3,2013/03/15(10:00)
2013,03,14,82520,74976,66346,8630,13,2013/03/14(10:00)
2013,03,13,82520,74637,66668,7969,12,2013/03/13(11:00)
2013,03,12,82520,74563,66052,8511,12.9,2013/03/12(10:00)
2013,03,11,82520,74917,66073,8844,13.4,2013/03/11(11:00)
2013,03,10,82520,72899,55328,17571,31.8,2013/03/10(23:00)
2013,03,09,82520,72301,57125,15176,26.6,2013/03/09(11:00)
2013,03,08,82520,75458,66335,9123,13.8,2013/03/08(10:00)
2013,03,07,82520,75324,66035,9289,14.1,2013/03/07(11:00)
2013,03,06,82520,75894,68551,7343,10.7,2013/03/06(10:00)
2013,03,05,82520,76074,69252,6822,9.9,2013/03/05(10:00)
2013,03,04,82520,76523,69653,6870,9.9,2013/03/04(11:00)
2013,03,03,82520,73966,57568,16398,28.5,2013/03/03(23:00)
2013,03,02,82520,73991,60144,13847,23,2013/03/02(24:00)
2013,03,01,82520,74147,61639,12508,20.3,2013/03/01(24:00)
2013,02,28,82296,75904,66378,9526,14.4,2013/02/28(10:00)
2013,02,27,82296,76114,66919,9195,13.7,2013/02/27(10:00)
2013,02,26,82296,76725,69758,6967,10,2013/02/26(11:00)
2013,02,25,82296,76806,69513,7293,10.5,2013/02/25(11:00)
2013,02,24,82296,75013,59503,15510,26.1,2013/02/24(01:00)
2013,02,23,82296,74790,62773,12017,19.1,2013/02/23(11:00)
2013,02,22,82296,77225,70240,6985,9.9,2013/02/22(10:00)
2013,02,21,82296,77022,71294,5728,8,2013/02/21(10:00)
2013,02,20,82296,77534,71826,5708,7.9,2013/02/20(10:00)
2013,02,19,82296,76628,71243,5385,7.6,2013/02/19(10:00)
2013,02,18,82296,75669,70278,5391,7.7,2013/02/18(10:00)
2013,02,17,82296,75216,59718,15498,26,2013/02/17(01:00)
2013,02,16,82296,75072,63952,11120,17.4,2013/02/16(11:00)
2013,02,15,82296,77804,69697,8107,11.6,2013/02/15(10:00)
2013,02,14,82296,77815,71414,6401,9,2013/02/14(10:00)
2013,02,13,82296,77572,70551,7021,10,2013/02/13(10:00)
2013,02,12,82296,76879,62525,14354,23,2013/02/12(12:00)
2013,02,11,82296,76286,56338,19948,35.4,2013/02/11(24:00)
2013,02,10,82296,75694,54678,21016,38.4,2013/02/10(01:00)
2013,02,09,82296,76723,62468,14255,22.8,2013/02/09(01:00)
2013,02,08,82296,79482,74196,5286,7.1,2013/02/08(10:00)
2013,02,07,82296,79338,73964,5374,7.3,2013/02/07(10:00)
2013,02,06,82296,79022,70985,8037,11.3,2013/02/06(10:00)
2013,02,05,82296,78931,72515,6416,8.8,2013/02/05(10:00)
2013,02,04,82296,78475,70352,8123,11.5,2013/02/04(10:00)
2013,02,03,82296,76538,60333,16205,26.9,2013/02/03(24:00)
2013,02,02,82296,75023,62234,12789,20.5,2013/02/02(24:00)
2013,02,01,82296,78642,67350,11292,16.8,2013/02/01(10:00)
2013,01,31,82296,79320,69136,10184,14.7,2013/01/31(10:00)
2013,01,30,82296,79606,70366,9240,13.1,2013/01/30(10:00)
2013,01,29,82296,80537,72309,8228,11.4,2013/01/29(10:00)
2013,01,28,82296,79415,73589,5826,7.9,2013/01/28(10:00)
2013,01,27,82296,77344,63092,14252,22.6,2013/01/27(01:00)
2013,01,26,82296,79541,66011,13530,20.5,2013/01/26(01:00)
2013,01,25,82296,80578,73340,7238,9.9,2013/01/25(10:00)
2013,01,24,82296,80037,70895,9142,12.9,2013/01/24(10:00)
2013,01,23,82296,79568,70555,9013,12.8,2013/01/23(10:00)
2013,01,22,82296,78867,70439,8428,12,2013/01/22(10:00)
2013,01,21,82296,80040,71696,8344,11.6,2013/01/21(15:00)
2013,01,20,82296,78117,61013,17104,28,2013/01/20(01:00)
2013,01,19,82296,79390,64737,14653,22.6,2013/01/19(01:00)
2013,01,18,82296,80077,74135,5942,8,2013/01/18(10:00)
2013,01,17,82296,81332,73613,7719,10.5,2013/01/17(10:00)
2013,01,16,82296,80558,72808,7750,10.6,2013/01/16(10:00)
2013,01,15,82296,80545,73364,7181,9.8,2013/01/15(10:00)
2013,01,14,82296,80296,72869,7427,10.2,2013/01/14(10:00)
2013,01,13,82296,78708,61334,17374,28.3,2013/01/13(01:00)
2013,01,12,82296,78759,65458,13301,20.3,2013/01/12(01:00)
2013,01,11,82296,81220,75583,5637,7.5,2013/01/11(10:00)
2013,01,10,82296,81360,75570,5790,7.7,2013/01/10(10:00)
2013,01,09,82296,81318,75609,5709,7.6,2013/01/09(10:00)
2013,01,08,82296,80944,75220,5724,7.6,2013/01/08(10:00)
2013,01,07,82296,80129,75383,4746,6.3,2013/01/07(10:00)
2013,01,06,82296,80965,64147,16818,26.2,2013/01/06(01:00)
2013,01,05,82296,80620,68053,12567,18.5,2013/01/05(01:00)
2013,01,04,82296,80843,76375,4468,5.9,2013/01/04(11:00)
2013,01,03,82296,80713,76522,4191,5.5,2013/01/03(11:00)
2013,01,02,82296,80125,73387,6738,9.2,2013/01/02(18:00)
2013,01,01,82296,76730,60178,16552,27.5,2013/01/01(01:00)
2012,12,31,81806,78269,65266,13003,19.9,2012/12/31(11:00)
2012,12,30,81806,76403,61819,14584,23.6,2012/12/30(24:00)
2012,12,29,81806,74180,63609,10571,16.6,2012/12/29(12:00)
2012,12,28,81806,78431,73073,5358,7.3,2012/12/28(12:00)
2012,12,27,81806,79560,75105,4455,5.9,2012/12/27(11:00)
2012,12,26,81806,79972,75987,3985,5.2,2012/12/26(11:00)
2012,12,25,81806,78589,65874,12715,19.3,2012/12/25(24:00)
2012,12,24,81806,79445,74300,5145,6.9,2012/12/24(11:00)
2012,12,23,81806,77136,63306,13830,21.8,2012/12/23(24:00)
2012,12,22,81806,75680,64515,11165,17.3,2012/12/22(11:00)
2012,12,21,81806,79337,74947,4390,5.9,2012/12/21(11:00)
2012,12,20,81806,79540,75154,4386,5.8,2012/12/20(11:00)
2012,12,19,81806,77914,67769,10145,15,2012/12/19(19:00)
2012,12,18,81806,79723,75172,4551,6.1,2012/12/18(11:00)
2012,12,17,81806,77109,72407,4702,6.5,2012/12/17(11:00)
2012,12,16,81806,74541,59375,15166,25.5,2012/12/16(24:00)
2012,12,15,81806,74497,63513,10984,17.3,2012/12/15(11:00)
2012,12,14,81806,78112,73928,4184,5.7,2012/12/14(12:00)
2012,12,13,81806,78018,73244,4774,6.5,2012/12/13(11:00)
2012,12,12,81806,77915,73890,4025,5.4,2012/12/12(11:00)
2012,12,11,81806,77785,74052,3733,5,2012/12/11(11:00)
2012,12,10,81806,78748,74269,4479,6,2012/12/10(11:00)
2012,12,09,81806,76236,62638,13598,21.7,2012/12/09(24:00)
2012,12,08,81806,75673,64826,10847,16.7,2012/12/08(12:00)
2012,12,07,81806,77087,73291,3796,5.2,2012/12/07(12:00)
2012,12,06,81806,77176,72744,4432,6.1,2012/12/06(18:00)
2012,12,05,81806,77353,72502,4851,6.7,2012/12/05(11:00)
2012,12,04,81806,76647,71774,4873,6.8,2012/12/04(18:00)
2012,12,03,81806,75410,70771,4639,6.6,2012/12/03(11:00)
2012,12,02,81806,73052,57401,15651,27.3,2012/12/02(24:00)
2012,12,01,81806,71837,60745,11092,18.3,2012/12/01(11:00)
2012,11,30,81738,75686,68779,6907,10,2012/11/30(10:00)
2012,11,29,81738,75940,69062,6878,10,2012/11/29(11:00)
2012,11,28,81738,74423,68297,6126,9,2012/11/28(10:00)
2012,11,27,81738,74737,68958,5779,8.4,2012/11/27(10:00)
2012,11,26,81738,74242,68602,5640,8.2,2012/11/26(18:00)
2012,11,25,81738,72643,56021,16622,29.7,2012/11/25(24:00)
2012,11,24,81738,71305,59203,12102,20.4,2012/11/24(24:00)
2012,11,23,81738,72880,66568,6312,9.5,2012/11/23(10:00)
2012,11,22,81738,72661,66803,5858,8.8,2012/11/22(10:00)
2012,11,21,81738,72514,67861,4653,6.9,2012/11/21(10:00)
2012,11,20,81738,72205,67338,4867,7.2,2012/11/20(11:00)
2012,11,19,81738,72035,66846,5189,7.8,2012/11/19(19:00)
2012,11,18,81738,70125,55874,14251,25.5,2012/11/18(23:00)
2012,11,17,81738,69249,58325,10924,18.7,2012/11/17(24:00)
2012,11,16,81738,72320,65817,6503,9.9,2012/11/16(10:00)
2012,11,15,81738,71947,65600,6347,9.7,2012/11/15(19:00)
2012,11,14,81738,71352,65597,5755,8.8,2012/11/14(10:00)
2012,11,13,81738,70894,65071,5823,8.9,2012/11/13(19:00)
2012,11,12,81738,70630,63856,6774,10.6,2012/11/12(19:00)
2012,11,11,81738,68641,54242,14399,26.5,2012/11/11(23:00)
2012,11,10,81738,68618,55606,13012,23.4,2012/11/10(01:00)
2012,11,09,81738,68895,62933,5962,9.5,2012/11/09(10:00)
2012,11,08,81738,69457,63379,6078,9.6,2012/11/08(19:00)
2012,11,07,81738,69335,62448,6887,11,2012/11/07(10:00)
2012,11,06,81738,68811,63871,4940,7.7,2012/11/06(19:00)
2012,11,05,81738,68966,63267,5699,9,2012/11/05(19:00)
2012,11,04,81738,67051,53038,14013,26.4,2012/11/04(23:00)
2012,11,03,81738,67065,55191,11874,21.5,2012/11/03(11:00)
2012,11,02,81738,70266,61775,8491,13.7,2012/11/02(19:00)
2012,11,01,81738,68793,62758,6035,9.6,2012/11/01(19:00)
2012,10,31,81593,67910,61481,6429,10.5,2012/10/31(19:00)
2012,10,30,81593,66709,61165,5544,9.1,2012/10/30(19:00)
2012,10,29,81593,66707,61144,5563,9.1,2012/10/29(19:00)
2012,10,28,81593,64697,51516,13181,25.6,2012/10/28(23:00)
2012,10,27,81593,66361,55277,11084,20.1,2012/10/27(12:00)
2012,10,26,81593,68640,60371,8269,13.7,2012/10/26(19:00)
2012,10,25,81593,68204,61308,6896,11.2,2012/10/25(19:00)
2012,10,24,81593,69151,60965,8186,13.4,2012/10/24(19:00)
2012,10,23,81593,68349,61622,6727,10.9,2012/10/23(19:00)
2012,10,22,81593,67074,61429,5645,9.2,2012/10/22(19:00)
2012,10,21,81593,66967,51456,15511,30.1,2012/10/21(20:00)
2012,10,20,81593,67401,54174,13227,24.4,2012/10/20(11:00)
2012,10,19,81593,68304,60020,8284,13.8,2012/10/19(19:00)
2012,10,18,81593,66903,61039,5864,9.6,2012/10/18(19:00)
2012,10,17,81593,67174,60257,6917,11.5,2012/10/17(19:00)
2012,10,16,81593,67066,60814,6252,10.3,2012/10/16(19:00)
2012,10,15,81593,66468,60196,6272,10.4,2012/10/15(19:00)
2012,10,14,81593,65570,50815,14755,29,2012/10/14(20:00)
2012,10,13,81593,63758,53632,10126,18.9,2012/10/13(11:00)
2012,10,12,81593,67130,59780,7350,12.3,2012/10/12(19:00)
2012,10,11,81593,67032,61169,5863,9.6,2012/10/11(19:00)
2012,10,10,81593,66316,60099,6217,10.3,2012/10/10(19:00)
2012,10,09,81593,66972,60972,6000,9.8,2012/10/09(19:00)
2012,10,08,81593,66529,60359,6170,10.2,2012/10/08(19:00)
2012,10,07,81552,65990,51457,14533,28.2,2012/10/07(20:00)
2012,10,06,81552,65306,55401,9905,17.9,2012/10/06(12:00)
2012,10,05,81552,67403,60138,7265,12.1,2012/10/05(19:00)
2012,10,04,81552,66919,59549,7370,12.4,2012/10/04(19:00)
2012,10,03,81552,63062,51925,11137,21.4,2012/10/03(20:00)
2012,10,02,81552,62826,48778,14048,28.8,2012/10/02(20:00)
2012,10,01,81552,68348,44079,24269,55.1,2012/10/01(20:00)
2012,09,30,81552,68556,41302,27254,66,2012/09/30(23:00)
2012,09,29,81552,68404,46048,22356,48.5,2012/09/29(01:00)
2012,09,28,81552,72886,58686,14200,24.2,2012/09/28(11:00)
2012,09,27,81552,71552,60988,10564,17.3,2012/09/27(15:00)
2012,09,26,81552,72410,61849,10561,17.1,2012/09/26(15:00)
2012,09,25,81552,71943,61999,9944,16,2012/09/25(15:00)
2012,09,24,81552,71787,61955,9832,15.9,2012/09/24(15:00)
2012,09,23,81552,72877,52648,20229,38.4,2012/09/23(20:00)
2012,09,22,81552,72408,56074,16334,29.1,2012/09/22(12:00)
2012,09,21,81552,74498,61504,12994,21.1,2012/09/21(15:00)
2012,09,20,81552,74582,61933,12649,20.4,2012/09/20(20:00)
2012,09,19,81552,75065,61552,13513,22,2012/09/19(15:00)
2012,09,18,81552,74227,61632,12595,20.4,2012/09/18(15:00)
2012,09,17,81552,73895,60517,13378,22.1,2012/09/17(11:00)
2012,09,16,81552,74634,52053,22581,43.4,2012/09/16(20:00)
2012,09,15,81552,76303,55814,20489,36.7,2012/09/15(12:00)
2012,09,14,81552,77768,61461,16307,26.5,2012/09/14(11:00)
2012,09,13,81552,77646,63730,13916,21.8,2012/09/13(15:00)
2012,09,12,81552,77114,63598,13516,21.3,2012/09/12(15:00)
2012,09,11,81552,77054,63690,13364,21,2012/09/11(15:00)
2012,09,10,81552,76532,63382,13150,20.7,2012/09/10(15:00)
2012,09,09,81552,76663,52607,24056,45.7,2012/09/09(20:00)
2012,09,08,81552,76753,56953,19800,34.8,2012/09/08(12:00)
2012,09,07,81552,77329,64860,12469,19.2,2012/09/07(15:00)
2012,09,06,81552,77408,64096,13312,20.8,2012/09/06(15:00)
2012,09,05,81552,77917,65566,12351,18.8,2012/09/05(15:00)
2012,09,04,81552,77257,66324,10933,16.5,2012/09/04(15:00)
2012,09,03,81552,77111,67693,9418,13.9,2012/09/03(15:00)
2012,09,02,81552,76153,54602,21551,39.5,2012/09/02(20:00)
2012,09,01,81552,75717,58196,17521,30.1,2012/09/01(15:00)
2012,08,31,81552,78223,64788,13435,20.7,2012/08/31(15:00)
2012,08,30,81552,77862,65840,12022,18.3,2012/08/30(11:00)
2012,08,29,81552,77459,68780,8679,12.6,2012/08/29(15:00)
2012,08,28,81552,74527,65715,8812,13.4,2012/08/28(15:00)
2012,08,27,81552,76474,71046,5428,7.6,2012/08/27(15:00)
2012,08,26,81552,76491,58068,18423,31.7,2012/08/26(21:00)
2012,08,25,81552,75261,60599,14662,24.2,2012/08/25(15:00)
2012,08,24,81552,76974,63708,13266,20.8,2012/08/24(15:00)
2012,08,23,81552,76985,64960,12025,18.5,2012/08/23(15:00)
2012,08,22,81552,77145,66037,11108,16.8,2012/08/22(11:00)
2012,08,21,81552,76855,70992,5863,8.3,2012/08/21(15:00)
2012,08,20,81552,76651,71059,5592,7.9,2012/08/20(15:00)
2012,08,19,81552,76612,59360,17252,29.1,2012/08/19(21:00)
2012,08,18,81552,76976,63768,13208,20.7,2012/08/18(12:00)
2012,08,17,81552,77897,71135,6762,9.5,2012/08/17(15:00)
2012,08,16,81552,77836,69481,8355,12,2012/08/16(15:00)
2012,08,15,81552,77711,62387,15324,24.6,2012/08/15(12:00)
2012,08,14,81552,77574,69018,8556,12.4,2012/08/14(15:00)
2012,08,13,81552,77637,69090,8547,12.4,2012/08/13(15:00)
2012,08,12,81552,77839,57960,19879,34.3,2012/08/12(21:00)
2012,08,11,81552,76149,63524,12625,19.9,2012/08/11(15:00)
2012,08,10,81552,77039,70288,6751,9.6,2012/08/10(12:00)
2012,08,09,81552,77093,72940,4153,5.7,2012/08/09(15:00)
2012,08,08,81552,76698,72497,4201,5.8,2012/08/08(15:00)
2012,08,07,81552,76904,73653,3251,4.4,2012/08/07(15:00)
2012,08,06,81552,77082,74291,2791,3.8,2012/08/06(15:00)
2012,08,05,81552,75498,63236,12262,19.4,2012/08/05(21:00)
2012,08,04,81552,73708,62279,11429,18.4,2012/08/04(21:00)
2012,08,03,81552,74686,66851,7835,11.7,2012/08/03(15:00)
2012,08,02,81552,75004,67314,7690,11.4,2012/08/02(15:00)
2012,08,01,81552,75173,68525,6648,9.7,2012/08/01(15:00)
2012,07,31,80552,75927,70763,5164,7.3,2012/07/31(15:00)
2012,07,30,80552,76478,69856,6622,9.5,2012/07/30(15:00)
2012,07,29,80552,75769,60779,14990,24.7,2012/07/29(21:00)
2012,07,28,80552,74416,64680,9736,15.1,2012/07/28(15:00)
2012,07,27,80552,77563,72704,4859,6.7,2012/07/27(12:00)
2012,07,26,80552,77179,72630,4549,6.3,2012/07/26(15:00)
2012,07,25,80552,76906,72784,4122,5.7,2012/07/25(15:00)
2012,07,24,80552,77324,72913,4411,6,2012/07/24(15:00)
2012,07,23,80552,77246,72595,4651,6.4,2012/07/23(15:00)
2012,07,22,80552,75206,57900,17306,29.9,2012/07/22(21:00)
2012,07,21,80552,73351,62512,10839,17.3,2012/07/21(15:00)
2012,07,20,79552,75402,69021,6381,9.2,2012/07/20(15:00)
2012,07,19,79552,75113,67871,7242,10.7,2012/07/19(15:00)
2012,07,18,79552,74931,68952,5979,8.7,2012/07/18(15:00)
2012,07,17,79552,74690,66197,8493,12.8,2012/07/17(15:00)
2012,07,16,79552,74560,64442,10118,15.7,2012/07/16(15:00)
2012,07,15,79552,75134,53714,21420,39.9,2012/07/15(21:00)
2012,07,14,79552,74192,59922,14270,23.8,2012/07/14(12:00)
2012,07,13,79552,74574,68543,6031,8.8,2012/07/13(15:00)
2012,07,12,79552,74438,67740,6698,9.9,2012/07/12(15:00)
2012,07,11,79552,74840,67862,6978,10.3,2012/07/11(15:00)
2012,07,10,79552,73993,67961,6032,8.9,2012/07/10(15:00)
2012,07,09,79552,73081,68751,4330,6.3,2012/07/09(17:00)
2012,07,08,79552,71963,54057,17906,33.1,2012/07/08(21:00)
2012,07,07,79552,72062,57899,14163,24.5,2012/07/07(12:00)
2012,07,06,79552,72385,65582,6803,10.4,2012/07/06(15:00)
2012,07,05,79552,72318,66378,5940,8.9,2012/07/05(15:00)
2012,07,04,79552,72449,67858,4591,6.8,2012/07/04(15:00)
2012,07,03,79552,71681,66433,5248,7.9,2012/07/03(15:00)
2012,07,02,79552,71481,65642,5839,8.9,2012/07/02(15:00)
2012,07,01,79552,70096,53160,16936,31.9,2012/07/01(21:00)
2012,06,30,79552,68268,59230,9038,15.3,2012/06/30(12:00)
2012,06,29,79552,71823,67390,4433,6.6,2012/06/29(15:00)
2012,06,28,79552,72179,65842,6337,9.6,2012/06/28(15:00)
2012,06,27,79552,72026,65558,6468,9.9,2012/06/27(15:00)
2012,06,26,79552,72099,65382,6717,10.3,2012/06/26(15:00)
2012,06,25,79552,71940,66791,5149,7.7,2012/06/25(15:00)
2012,06,24,79552,69137,54183,14954,27.6,2012/06/24(21:00)
2012,06,23,79552,70998,60035,10963,18.3,2012/06/23(15:00)
2012,06,22,79552,71963,66429,5534,8.3,2012/06/22(15:00)
2012,06,21,79552,72375,66934,5441,8.1,2012/06/21(17:00)
2012,06,20,79432,72235,67009,5226,7.8,2012/06/20(15:00)
2012,06,19,79432,71275,66982,4293,6.4,2012/06/19(15:00)
2012,06,18,79432,70254,66205,4049,6.1,2012/06/18(15:00)
2012,06,17,79432,67228,53298,13930,26.1,2012/06/17(21:00)
2012,06,16,79432,67250,58330,8920,15.3,2012/06/16(12:00)
2012,06,15,79432,69375,63990,5385,8.4,2012/06/15(12:00)
2012,06,14,79432,69561,64546,5015,7.8,2012/06/14(17:00)
2012,06,13,79432,69132,63780,5352,8.4,2012/06/13(15:00)
2012,06,12,79432,68713,64506,4207,6.5,2012/06/12(15:00)
2012,06,11,79432,68520,63222,5298,8.4,2012/06/11(15:00)
2012,06,10,79432,65838,52788,13050,24.7,2012/06/10(21:00)
2012,06,09,79432,64763,57383,7380,12.9,2012/06/09(15:00)
2012,06,08,79432,67317,62556,4761,7.6,2012/06/08(15:00)
2012,06,07,79432,66781,63340,3441,5.4,2012/06/07(15:00)
2012,06,06,79432,66085,59139,6946,11.7,2012/06/06(15:00)
2012,06,05,79432,67117,62958,4159,6.6,2012/06/05(15:00)
2012,06,04,79432,66931,62206,4725,7.6,2012/06/04(15:00)
2012,06,03,79432,64378,51865,12513,24.1,2012/06/03(21:00)
2012,06,02,79432,62226,56122,6104,10.9,2012/06/02(12:00)
2012,06,01,79432,65095,60411,4684,7.8,2012/06/01(15:00)
2012,05,31,79432,65160,60991,4169,6.8,2012/05/31(15:00)
2012,05,30,79432,65883,60395,5488,9.1,2012/05/30(17:00)
2012,05,29,79432,65095,60116,4979,8.3,2012/05/29(17:00)
2012,05,28,79432,64073,53876,10197,18.9,2012/05/28(21:00)
2012,05,27,79432,61403,50165,11238,22.4,2012/05/27(21:00)
2012,05,26,79432,61720,54131,7589,14,2012/05/26(12:00)
2012,05,25,79432,66444,60262,6182,10.3,2012/05/25(15:00)
2012,05,24,79432,65855,60583,5272,8.7,2012/05/24(15:00)
2012,05,23,79432,65529,61029,4500,7.4,2012/05/23(15:00)
2012,05,22,79432,65600,60915,4685,7.7,2012/05/22(15:00)
2012,05,21,79432,64425,59738,4687,7.8,2012/05/21(17:00)
2012,05,20,79432,63140,51396,11744,22.9,2012/05/20(21:00)
2012,05,19,79432,62762,54050,8712,16.1,2012/05/19(12:00)
2012,05,18,79432,64337,58805,5532,9.4,2012/05/18(12:00)
2012,05,17,79432,65656,59354,6302,10.6,2012/05/17(11:00)
2012,05,16,79432,65950,59297,6653,11.2,2012/05/16(15:00)
2012,05,15,79432,65684,59545,6139,10.3,2012/05/15(15:00)
2012,05,14,79432,65847,60105,5742,9.6,2012/05/14(15:00)
2012,05,13,79432,64424,50870,13554,26.6,2012/05/13(21:00)
2012,05,12,79432,63333,53474,9859,18.4,2012/05/12(11:00)
2012,05,11,79432,65776,59389,6387,10.8,2012/05/11(17:00)
2012,05,10,79432,64651,59469,5182,8.7,2012/05/10(17:00)
2012,05,09,79432,64450,59180,5270,8.9,2012/05/09(15:00)
2012,05,08,79432,64388,59726,4662,7.8,2012/05/08(15:00)
2012,05,07,79432,64703,58783,5920,10.1,2012/05/07(15:00)
2012,05,06,79432,63838,49265,14573,29.6,2012/05/06(21:00)
2012,05,05,79432,62753,51023,11730,23,2012/05/05(21:00)
2012,05,04,79432,64206,58254,5952,10.2,2012/05/04(15:00)
2012,05,03,79432,64136,58681,5455,9.3,2012/05/03(15:00)
2012,05,02,79432,63419,59194,4225,7.1,2012/05/02(15:00)
2012,05,01,79432,63986,53469,10517,19.7,2012/05/01(21:00)
2012,04,30,79432,63614,57303,6311,11,2012/04/30(17:00)
2012,04,29,79432,63015,50060,12955,25.9,2012/04/29(21:00)
2012,04,28,79432,65313,52289,13024,24.9,2012/04/28(11:00)
2012,04,27,79432,66367,57420,8947,15.6,2012/04/27(15:00)
2012,04,26,79432,66414,58571,7843,13.4,2012/04/26(20:00)
2012,04,25,79432,65664,60184,5480,9.1,2012/04/25(15:00)
2012,04,24,79432,64662,57954,6708,11.6,2012/04/24(21:00)
2012,04,23,79432,65692,59092,6600,11.2,2012/04/23(11:00)
2012,04,22,79432,62827,51897,10930,21.1,2012/04/22(23:00)
2012,04,21,79432,62424,56020,6404,11.4,2012/04/21(12:00)
2012,04,20,79432,66515,58827,7688,13.1,2012/04/20(20:00)
2012,04,19,79432,66638,59736,6902,11.6,2012/04/19(20:00)
2012,04,18,79432,65974,58531,7443,12.7,2012/04/18(11:00)
2012,04,17,79432,66163,59495,6668,11.2,2012/04/17(20:00)
2012,04,16,79432,65870,59317,6553,11,2012/04/16(20:00)
2012,04,15,79432,63956,51032,12924,25.3,2012/04/15(23:00)
2012,04,14,79432,65061,54323,10738,19.8,2012/04/14(11:00)
2012,04,13,79432,67398,59998,7400,12.3,2012/04/13(20:00)
2012,04,12,79432,67787,60318,7469,12.4,2012/04/12(20:00)
2012,04,11,79432,67406,57192,10214,17.9,2012/04/11(11:00)
2012,04,10,79432,66938,60615,6323,10.4,2012/04/10(17:00)
2012,04,09,79432,67012,59632,7380,12.4,2012/04/09(11:00)
2012,04,08,79432,66356,52545,13811,26.3,2012/04/08(23:00)
2012,04,07,79432,66934,56470,10464,18.5,2012/04/07(11:00)
2012,04,06,79432,69404,61955,7449,12,2012/04/06(11:00)
2012,04,05,79432,69374,61447,7927,12.9,2012/04/05(20:00)
2012,04,04,79432,69319,62455,6864,11,2012/04/04(10:00)
2012,04,03,79432,69474,64390,5084,7.9,2012/04/03(11:00)
2012,04,02,79432,69866,62058,7808,12.6,2012/04/02(11:00)
2012,04,01,79432,68340,53824,14516,27,2012/04/01(23:00)
2012,03,31,79648,68874,55993,12881,23,2012/03/31(24:00)
2012,03,30,79648,69940,62023,7917,12.8,2012/03/30(11:00)
2012,03,29,79648,70777,61505,9272,15.1,2012/03/29(10:00)
2012,03,28,79648,71122,62671,8451,13.5,2012/03/28(10:00)
2012,03,27,79648,71373,64132,7241,11.3,2012/03/27(11:00)
2012,03,26,79648,71863,65406,6457,9.9,2012/03/26(11:00)
2012,03,25,79648,70747,55600,15147,27.2,2012/03/25(23:00)
2012,03,24,79648,70539,58455,12084,20.7,2012/03/24(24:00)
2012,03,23,79648,72152,65916,6236,9.5,2012/03/23(11:00)
2012,03,22,79648,72030,66314,5716,8.6,2012/03/22(11:00)
2012,03,21,79648,73008,65554,7454,11.4,2012/03/21(10:00)
2012,03,20,79648,72901,65917,6984,10.6,2012/03/20(10:00)
2012,03,19,79648,72879,65929,6950,10.5,2012/03/19(11:00)
2012,03,18,79648,69438,55516,13922,25.1,2012/03/18(23:00)
2012,03,17,79648,69509,58487,11022,18.8,2012/03/17(11:00)
2012,03,16,79648,73753,65949,7804,11.8,2012/03/16(11:00)
2012,03,15,79648,73696,66662,7034,10.6,2012/03/15(10:00)
2012,03,14,79648,73918,67941,5977,8.8,2012/03/14(10:00)
2012,03,13,79648,74651,67944,6707,9.9,2012/03/13(10:00)
2012,03,12,79648,75420,69180,6240,9,2012/03/12(11:00)
2012,03,11,79648,72420,58214,14206,24.4,2012/03/11(24:00)
2012,03,10,79648,71155,59193,11962,20.2,2012/03/10(11:00)
2012,03,09,79648,73878,67403,6475,9.6,2012/03/09(11:00)
2012,03,08,79648,74527,67407,7120,10.6,2012/03/08(10:00)
2012,03,07,79648,74302,67480,6822,10.1,2012/03/07(10:00)
2012,03,06,79342,73986,68119,5867,8.6,2012/03/06(11:00)
2012,03,05,79342,74085,67475,6610,9.8,2012/03/05(11:00)
2012,03,04,79342,73226,55923,17303,30.9,2012/03/04(23:00)
2012,03,03,79342,73369,57884,15485,26.8,2012/03/03(24:00)
2012,03,02,79342,74949,65461,9488,14.5,2012/03/02(11:00)
2012,03,01,79342,74921,59676,15245,25.5,2012/03/01(23:00)
2012,02,29,79342,75066,66910,8156,12.2,2012/02/29(10:00)
2012,02,28,79342,76552,69091,7461,10.8,2012/02/28(10:00)
2012,02,27,79342,75408,68116,7292,10.7,2012/02/27(11:00)
2012,02,26,79342,73833,58687,15146,25.8,2012/02/26(24:00)
2012,02,25,79342,76126,60731,15395,25.3,2012/02/25(24:00)
2012,02,24,79342,77736,66140,11596,17.5,2012/02/24(10:00)
2012,02,23,79342,77384,66267,11117,16.8,2012/02/23(10:00)
2012,02,22,79342,77978,68837,9141,13.3,2012/02/22(10:00)
2012,02,21,79342,77532,70066,7466,10.7,2012/02/21(10:00)
2012,02,20,79342,77591,70433,7158,10.2,2012/02/20(10:00)
2012,02,19,79342,77627,60733,16894,27.8,2012/02/19(01:00)
2012,02,18,79342,77710,64121,13589,21.2,2012/02/18(11:00)
2012,02,17,79342,77791,70987,6804,9.6,2012/02/17(10:00)
2012,02,16,79342,78068,69414,8654,12.5,2012/02/16(10:00)
2012,02,15,79342,77973,69690,8283,11.9,2012/02/15(10:00)
2012,02,14,79342,77780,70253,7527,10.7,2012/02/14(10:00)
2012,02,13,79342,77402,71147,6255,8.8,2012/02/13(11:00)
2012,02,12,79342,77513,60365,17148,28.4,2012/02/12(01:00)
2012,02,11,79342,78199,64071,14128,22.1,2012/02/11(01:00)
2012,02,10,79342,78845,72535,6310,8.7,2012/02/10(10:00)
2012,02,09,79342,78802,72432,6370,8.8,2012/02/09(10:00)
2012,02,08,79342,79594,73131,6463,8.8,2012/02/08(10:00)
2012,02,07,79342,79034,73098,5936,8.1,2012/02/07(10:00)
2012,02,06,79342,78517,72008,6509,9,2012/02/06(10:00)
2012,02,05,79342,77110,61327,15783,25.7,2012/02/05(01:00)
2012,02,04,79342,77440,65486,11954,18.3,2012/02/04(01:00)
2012,02,03,79342,79449,73040,6409,8.8,2012/02/03(11:00)
2012,02,02,79342,79505,73833,5672,7.7,2012/02/02(11:00)
2012,02,01,79342,79433,72012,7421,10.3,2012/02/01(15:00)
2012,01,31,79342,79358,72308,7050,9.7,2012/01/31(10:00)
2012,01,30,79342,79502,71609,7893,11,2012/01/30(11:00)
2012,01,29,79342,78744,60436,18308,30.3,2012/01/29(24:00)
2012,01,28,79342,78278,63016,15262,24.2,2012/01/28(11:00)
2012,01,27,79342,79229,71023,8206,11.6,2012/01/27(11:00)
2012,01,26,79342,79444,70451,8993,12.8,2012/01/26(11:00)
2012,01,25,79342,78691,63424,15267,24.1,2012/01/25(12:00)
2012,01,24,79342,77254,56051,21203,37.8,2012/01/24(24:00)
2012,01,23,79342,77051,53318,23733,44.5,2012/01/23(24:00)
2012,01,22,79342,75962,54550,21412,39.3,2012/01/22(01:00)
2012,01,21,79342,77702,58618,19084,32.6,2012/01/21(01:00)
2012,01,20,79342,78701,66299,12402,18.7,2012/01/20(10:00)
2012,01,19,79342,78219,69189,9030,13.1,2012/01/19(10:00)
2012,01,18,79342,78992,69874,9118,13,2012/01/18(10:00)
2012,01,17,79342,78532,69998,8534,12.2,2012/01/17(10:00)
2012,01,16,79342,78635,71422,7213,10.1,2012/01/16(10:00)
2012,01,15,79342,78840,60377,18463,30.6,2012/01/15(24:00)
2012,01,14,79342,77885,63746,14139,22.2,2012/01/14(11:00)
2012,01,13,79342,78157,71893,6264,8.7,2012/01/13(10:00)
2012,01,12,79342,78388,71980,6408,8.9,2012/01/12(11:00)
2012,01,11,79342,79069,72453,6616,9.1,2012/01/11(10:00)
2012,01,10,79342,78816,71620,7196,10,2012/01/10(10:00)
2012,01,09,79342,78728,71646,7082,9.9,2012/01/09(10:00)
2012,01,08,79342,78074,61089,16985,27.8,2012/01/08(01:00)
2012,01,07,79342,78611,64570,14041,21.7,2012/01/07(11:00)
2012,01,06,79342,78897,72552,6345,8.7,2012/01/06(10:00)
2012,01,05,79342,79061,72199,6862,9.5,2012/01/05(10:00)
2012,01,04,79342,78969,72865,6104,8.4,2012/01/04(10:00)
2012,01,03,79342,78653,71631,7022,9.8,2012/01/03(10:00)
2012,01,02,79342,78563,69015,9548,13.8,2012/01/02(11:00)
2012,01,01,79342,78281,58124,20157,34.7,2012/01/01(24:00)
2011,12,31,79342,79891,60312,19579,32.5,2011/12/31(01:00)
2011,12,30,79342,80044,68524,11520,16.8,2011/12/30(10:00)
2011,12,29,79342,80094,68986,11108,16.1,2011/12/29(10:00)
2011,12,28,79342,79813,71482,8331,11.7,2011/12/28(10:00)
2011,12,27,79342,79705,72554,7151,9.9,2011/12/27(10:00)
2011,12,26,79342,79440,72128,7312,10.1,2011/12/26(11:00)
2011,12,25,79342,77224,60765,16459,27.1,2011/12/25(24:00)
2011,12,24,79342,79009,63489,15520,24.4,2011/12/24(01:00)
2011,12,23,79342,79663,71886,7777,10.8,2011/12/23(10:00)
2011,12,22,79342,79063,70990,8073,11.4,2011/12/22(10:00)
2011,12,21,79342,78469,70090,8379,12,2011/12/21(10:00)
2011,12,20,79342,78095,71573,6522,9.1,2011/12/20(10:00)
2011,12,19,79342,77097,71145,5952,8.4,2011/12/19(10:00)
2011,12,18,79342,76394,60134,16260,27,2011/12/18(24:00)
2011,12,17,79342,75751,64187,11564,18,2011/12/17(11:00)
2011,12,16,79342,76723,69899,6824,9.8,2011/12/16(17:00)
2011,12,15,79342,75863,68667,7196,10.5,2011/12/15(17:00)
2011,12,14,79213,75231,68985,6246,9.1,2011/12/14(10:00)
2011,12,13,79213,77518,69017,8501,12.3,2011/12/13(10:00)
2011,12,12,79213,77133,67595,9538,14.1,2011/12/12(18:00)
2011,12,11,79213,76271,57849,18422,31.8,2011/12/11(01:00)
2011,12,10,79213,75643,61464,14179,23.1,2011/12/10(11:00)
2011,12,09,79213,76942,69410,7532,10.9,2011/12/09(11:00)
2011,12,08,79213,76779,68671,8108,11.8,2011/12/08(18:00)
2011,12,07,79213,77449,66500,10949,16.5,2011/12/07(11:00)
2011,12,06,79213,77572,67180,10392,15.5,2011/12/06(11:00)
2011,12,05,79213,77270,67115,10155,15.1,2011/12/05(18:00)
2011,12,04,79213,75204,55878,19326,34.6,2011/12/04(24:00)
2011,12,03,79213,74497,57807,16690,28.9,2011/12/03(11:00)
2011,12,02,79213,76908,65139,11769,18.1,2011/12/02(11:00)
2011,12,01,79213,76409,65542,10867,16.6,2011/12/01(18:00)
2011,11,30,79213,77072,64892,12180,18.8,2011/11/30(15:00)
2011,11,29,79213,75656,63079,12577,19.9,2011/11/29(18:00)
2011,11,28,79213,74543,62210,12333,19.8,2011/11/28(11:00)
2011,11,27,79213,72207,54280,17927,33,2011/11/27(01:00)
2011,11,26,79213,72069,58814,13255,22.5,2011/11/26(11:00)
2011,11,25,79213,75040,66512,8528,12.8,2011/11/25(10:00)
2011,11,24,79213,75460,67554,7906,11.7,2011/11/24(18:00)
2011,11,23,79213,76153,66818,9335,14,2011/11/23(18:00)
2011,11,22,79213,74856,65709,9147,13.9,2011/11/22(18:00)
2011,11,21,79213,75221,65357,9864,15.1,2011/11/21(19:00)
2011,11,20,79213,73469,54654,18815,34.4,2011/11/20(23:00)
2011,11,19,79213,72269,55031,17238,31.3,2011/11/19(11:00)
2011,11,18,79213,75094,61210,13884,22.7,2011/11/18(18:00)
2011,11,17,79213,75098,62286,12812,20.6,2011/11/17(19:00)
2011,11,16,79213,75005,61292,13713,22.4,2011/11/16(19:00)
2011,11,15,79213,75560,62550,13010,20.8,2011/11/15(19:00)
2011,11,14,79213,75331,62271,13060,21,2011/11/14(19:00)
2011,11,13,79213,74064,52104,21960,42.1,2011/11/13(23:00)
2011,11,12,79213,73259,54054,19205,35.5,2011/11/12(11:00)
2011,11,11,79213,74649,60197,14452,24,2011/11/11(19:00)
2011,11,10,79213,73870,61125,12745,20.9,2011/11/10(19:00)
2011,11,09,79213,72781,60409,12372,20.5,2011/11/09(19:00)
2011,11,08,79213,72364,61174,11190,18.3,2011/11/08(19:00)
2011,11,07,79213,72931,60708,12223,20.1,2011/11/07(19:00)
2011,11,06,79213,70613,51533,19080,37,2011/11/06(23:00)
2011,11,05,79213,68640,54200,14440,26.6,2011/11/05(12:00)
2011,11,04,79213,70597,60326,10271,17,2011/11/04(19:00)
2011,11,03,79213,72140,60915,11225,18.4,2011/11/03(19:00)
2011,11,02,79213,72063,60192,11871,19.7,2011/11/02(19:00)
2011,11,01,79213,71945,60289,11656,19.3,2011/11/01(19:00)
2011,10,31,79213,71995,60913,11082,18.2,2011/10/31(19:00)
2011,10,30,78813,67857,51704,16153,31.2,2011/10/30(23:00)
2011,10,29,78813,68125,55053,13072,23.7,2011/10/29(11:00)
2011,10,28,78813,70804,60753,10051,16.5,2011/10/28(19:00)
2011,10,27,78813,70758,61921,8837,14.3,2011/10/27(19:00)
2011,10,26,78813,71077,61599,9478,15.4,2011/10/26(19:00)
2011,10,25,78813,71261,62575,8686,13.9,2011/10/25(19:00)
2011,10,24,78813,71308,61578,9730,15.8,2011/10/24(19:00)
2011,10,23,78813,69284,51428,17856,34.7,2011/10/23(23:00)
2011,10,22,78813,70165,54621,15544,28.5,2011/10/22(11:00)
2011,10,21,78813,71264,60554,10710,17.7,2011/10/21(19:00)
2011,10,20,78813,71075,61343,9732,15.9,2011/10/20(19:00)
2011,10,19,78813,71075,60644,10431,17.2,2011/10/19(19:00)
2011,10,18,78813,71029,61448,9581,15.6,2011/10/18(19:00)
2011,10,17,78813,70421,61107,9314,15.2,2011/10/17(19:00)
2011,10,16,78813,67909,50957,16952,33.3,2011/10/16(23:00)
2011,10,15,78813,69893,53962,15931,29.5,2011/10/15(12:00)
2011,10,14,78813,69937,60044,9893,16.5,2011/10/14(19:00)
2011,10,13,78813,69436,60907,8529,14,2011/10/13(19:00)
2011,10,12,78813,69499,60476,9023,14.9,2011/10/12(19:00)
2011,10,11,78813,69354,60691,8663,14.3,2011/10/11(19:00)
2011,10,10,78813,70164,60712,9452,15.6,2011/10/10(19:00)
2011,10,09,78813,67647,50842,16805,33.1,2011/10/09(20:00)
2011,10,08,78813,67923,53737,14186,26.4,2011/10/08(11:00)
2011,10,07,78813,69673,59674,9999,16.8,2011/10/07(19:00)
2011,10,06,78813,70922,60086,10836,18,2011/10/06(19:00)
2011,10,05,78813,71323,59182,12141,20.5,2011/10/05(19:00)
2011,10,04,78813,70880,59282,11598,19.6,2011/10/04(19:00)
2011,10,03,78813,69938,53024,16914,31.9,2011/10/03(20:00)
2011,10,02,78813,68207,49454,18753,37.9,2011/10/02(23:00)
2011,10,01,78813,69755,52404,17351,33.1,2011/10/01(11:00)
2011,09,30,78813,70389,57516,12873,22.4,2011/09/30(20:00)
2011,09,29,78813,69558,60274,9284,15.4,2011/09/29(19:00)
2011,09,28,78813,69942,59963,9979,16.6,2011/09/28(15:00)
2011,09,27,78813,70085,61003,9082,14.9,2011/09/27(20:00)
2011,09,26,78813,70085,60018,10067,16.8,2011/09/26(20:00)
2011,09,25,78813,68698,51479,17219,33.4,2011/09/25(20:00)
2011,09,24,78813,67993,54366,13627,25.1,2011/09/24(12:00)
2011,09,23,78813,69907,59500,10407,17.5,2011/09/23(15:00)
2011,09,22,78813,70786,59707,11079,18.6,2011/09/22(20:00)
2011,09,21,78813,70175,58737,11438,19.5,2011/09/21(15:00)
2011,09,20,78813,70317,59172,11145,18.8,2011/09/20(20:00)
2011,09,19,78813,70624,59227,11397,19.2,2011/09/19(20:00)
2011,09,18,78813,70022,52738,17284,32.8,2011/09/18(20:00)
2011,09,17,78813,69489,62936,6553,10.4,2011/09/17(15:00)
2011,09,16,78813,70811,67405,3406,5.1,2011/09/16(15:00)
2011,09,15,78813,70622,67281,3341,5,2011/09/15(15:00)
2011,09,14,78813,70135,58754,11381,19.4,2011/09/14(17:00)
2011,09,13,78813,72425,48043,24382,50.8,2011/09/13(20:00)
2011,09,12,78813,71797,42993,28804,67,2011/09/12(21:00)
2011,09,11,78813,72602,45021,27581,61.3,2011/09/11(20:00)
2011,09,10,78813,72300,51803,20497,39.6,2011/09/10(11:00)
2011,09,09,78813,74525,62293,12232,19.6,2011/09/09(11:00)
2011,09,08,78813,75421,64524,10897,16.9,2011/09/08(15:00)
2011,09,07,78813,75309,64990,10319,15.9,2011/09/07(15:00)
2011,09,06,78813,75435,66278,9157,13.8,2011/09/06(15:00)
2011,09,05,78813,75673,66594,9079,13.6,2011/09/05(15:00)
2011,09,04,78813,74517,54861,19656,35.8,2011/09/04(20:00)
2011,09,03,78813,74446,61977,12469,20.1,2011/09/03(15:00)
2011,09,02,79246,76885,71061,5824,8.2,2011/09/02(15:00)
2011,09,01,79246,77135,70529,6606,9.4,2011/09/01(15:00)
2011,08,31,79246,77636,72194,5442,7.5,2011/08/31(15:00)
2011,08,30,79246,77609,71745,5864,8.2,2011/08/30(15:00)
2011,08,29,79246,77409,70767,6642,9.4,2011/08/29(15:00)
2011,08,28,79246,77616,56941,20675,36.3,2011/08/28(21:00)
2011,08,27,79246,77880,60944,16936,27.8,2011/08/27(12:00)
2011,08,26,79246,78299,66226,12073,18.2,2011/08/26(15:00)
2011,08,25,79246,78340,65285,13055,20,2011/08/25(15:00)
2011,08,24,79246,77907,63959,13948,21.8,2011/08/24(15:00)
2011,08,23,79246,77977,63587,14390,22.6,2011/08/23(15:00)
2011,08,22,79246,77820,64261,13559,21.1,2011/08/22(15:00)
2011,08,21,79246,77977,53116,24861,46.8,2011/08/21(21:00)
2011,08,20,79246,78297,57322,20975,36.6,2011/08/20(12:00)
2011,08,19,79246,78497,65828,12669,19.2,2011/08/19(15:00)
2011,08,18,79246,78297,67527,10770,15.9,2011/08/18(15:00)
2011,08,17,79246,78367,67645,10722,15.9,2011/08/17(15:00)
2011,08,16,79246,78497,68649,9848,14.3,2011/08/16(15:00)
2011,08,15,79246,78497,59826,18671,31.2,2011/08/15(21:00)
2011,08,14,78810,78497,55352,23145,41.8,2011/08/14(21:00)
2011,08,13,78810,78580,60927,17653,29,2011/08/13(12:00)
2011,08,12,78810,78580,68112,10468,15.4,2011/08/12(15:00)
2011,08,11,78810,78580,69587,8993,12.9,2011/08/11(15:00)
2011,08,10,78810,78580,67776,10804,15.9,2011/08/10(15:00)
2011,08,09,78810,78340,67523,10817,16,2011/08/09(15:00)
2011,08,08,78810,77768,66784,10984,16.4,2011/08/08(15:00)
2011,08,07,78810,77702,57003,20699,36.3,2011/08/07(21:00)
2011,08,06,78810,77357,61767,15590,25.2,2011/08/06(15:00)
2011,08,05,78810,78305,67951,10354,15.2,2011/08/05(15:00)
2011,08,04,78810,78120,65124,12996,20,2011/08/04(15:00)
2011,08,03,78810,78120,61244,16876,27.6,2011/08/03(15:00)
2011,08,02,78810,78232,59306,18926,31.9,2011/08/02(15:00)
2011,08,01,78810,77404,57942,19462,33.6,2011/08/01(15:00)
2011,07,31,78810,77452,54326,23126,42.6,2011/07/31(21:00)
2011,07,30,78810,76406,58439,17967,30.7,2011/07/30(12:00)
2011,07,29,78810,77715,68307,9408,13.8,2011/07/29(15:00)
2011,07,28,78810,78483,67942,10541,15.5,2011/07/28(15:00)
2011,07,27,78810,78580,67464,11116,16.5,2011/07/27(15:00)
2011,07,26,78810,78580,68964,9616,13.9,2011/07/26(15:00)
2011,07,25,78810,78540,67965,10575,15.6,2011/07/25(15:00)
2011,07,24,78810,78108,55435,22673,40.9,2011/07/24(21:00)
2011,07,23,78810,78318,61339,16979,27.7,2011/07/23(15:00)
2011,07,22,78810,78922,66105,12817,19.4,2011/07/22(15:00)
2011,07,21,78810,78922,69173,9749,14.1,2011/07/21(15:00)
2011,07,20,78810,78722,70350,8372,11.9,2011/07/20(15:00)
2011,07,19,78810,78838,71393,7445,10.4,2011/07/19(15:00)
2011,07,18,78810,78838,70956,7882,11.1,2011/07/18(15:00)
2011,07,17,78810,76350,56518,19832,35.1,2011/07/17(21:00)
2011,07,16,78810,76984,61028,15956,26.1,2011/07/16(12:00)
2011,07,15,78810,76353,67140,9213,13.7,2011/07/15(15:00)
2011,07,14,78810,76839,66480,10359,15.6,2011/07/14(15:00)
2011,07,13,78810,76806,66087,10719,16.2,2011/07/13(15:00)
2011,07,12,78810,76134,65237,10897,16.7,2011/07/12(15:00)
2011,07,11,78810,76889,64240,12649,19.7,2011/07/11(15:00)
2011,07,10,78810,73915,53593,20322,37.9,2011/07/10(21:00)
2011,07,09,78810,75275,58040,17235,29.7,2011/07/09(12:00)
2011,07,08,78810,76081,64283,11798,18.4,2011/07/08(15:00)
2011,07,07,78810,76071,64622,11449,17.7,2011/07/07(15:00)
2011,07,06,78810,76671,65060,11611,17.8,2011/07/06(15:00)
2011,07,05,78810,76671,66128,10543,15.9,2011/07/05(15:00)
2011,07,04,78810,76423,64946,11477,17.7,2011/07/04(15:00)
2011,07,03,78810,75657,53332,22325,41.9,2011/07/03(21:00)
2011,07,02,78810,75716,59613,16103,27,2011/07/02(15:00)
2011,07,01,78810,74834,66358,8476,12.8,2011/07/01(15:00)
2011,06,30,78810,74689,65497,9192,14,2011/06/30(15:00)
2011,06,29,78810,73677,64414,9263,14.4,2011/06/29(15:00)
2011,06,28,78810,72656,64249,8407,13.1,2011/06/28(15:00)
2011,06,27,78810,72760,60942,11818,19.4,2011/06/27(17:00)
2011,06,26,78810,69847,50607,19240,38,2011/06/26(21:00)
2011,06,25,78810,68077,56412,11665,20.7,2011/06/25(12:00)
2011,06,24,78810,71770,63144,8626,13.7,2011/06/24(15:00)
2011,06,23,78810,72782,65856,6926,10.5,2011/06/23(15:00)
2011,06,22,78810,72673,64846,7827,12.1,2011/06/22(15:00)
2011,06,21,78810,71625,66254,5371,8.1,2011/06/21(15:00)
2011,06,20,78810,72091,66872,5219,7.8,2011/06/20(15:00)
2011,06,19,78810,70342,52965,17377,32.8,2011/06/19(21:00)
2011,06,18,78810,70863,57953,12910,22.3,2011/06/18(12:00)
2011,06,17,78810,71950,63935,8015,12.5,2011/06/17(15:00)
2011,06,16,78235,72225,64211,8014,12.5,2011/06/16(15:00)
2011,06,15,78235,72132,63471,8661,13.6,2011/06/15(15:00)
2011,06,14,78235,71870,62196,9674,15.6,2011/06/14(15:00)
2011,06,13,78235,71219,61587,9632,15.6,2011/06/13(15:00)
2011,06,12,78235,70549,51047,19502,38.2,2011/06/12(21:00)
2011,06,11,78235,68200,56286,11914,21.2,2011/06/11(15:00)
2011,06,10,78235,68962,61087,7875,12.9,2011/06/10(15:00)
2011,06,09,78235,67859,60058,7801,13,2011/06/09(16:00)
2011,06,08,78235,69302,61512,7790,12.7,2011/06/08(15:00)
2011,06,07,78235,68021,60236,7785,12.9,2011/06/07(15:00)
2011,06,06,78235,68242,53077,15165,28.6,2011/06/06(21:00)
2011,06,05,78235,67407,49207,18200,37,2011/06/05(21:00)
2011,06,04,78235,67685,53800,13885,25.8,2011/06/04(12:00)
2011,06,03,78235,68377,58448,9929,17,2011/06/03(15:00)
2011,06,02,78235,68374,58797,9577,16.3,2011/06/02(17:00)
2011,06,01,78235,68377,57787,10590,18.3,2011/06/01(15:00)
2011,05,31,78235,68980,58616,10364,17.7,2011/05/31(17:00)
2011,05,30,78235,69839,59330,10509,17.7,2011/05/30(15:00)
2011,05,29,78235,69468,50249,19219,38.2,2011/05/29(21:00)
2011,05,28,78235,70985,53420,17565,32.9,2011/05/28(12:00)
2011,05,27,78235,68208,58006,10202,17.6,2011/05/27(17:00)
2011,05,26,78235,68446,58444,10002,17.1,2011/05/26(15:00)
2011,05,25,78235,68265,58637,9628,16.4,2011/05/25(15:00)
2011,05,24,78235,67793,58142,9651,16.6,2011/05/24(15:00)
2011,05,23,78235,68011,57395,10616,18.5,2011/05/23(15:00)
2011,05,22,78235,67407,49822,17585,35.3,2011/05/22(21:00)
2011,05,21,78235,67581,54227,13354,24.6,2011/05/21(12:00)
2011,05,20,78235,68361,59355,9006,15.2,2011/05/20(15:00)
2011,05,19,78235,68105,58085,10020,17.3,2011/05/19(17:00)
2011,05,18,78235,69354,57557,11797,20.5,2011/05/18(15:00)
2011,05,17,78235,70020,56867,13153,23.1,2011/05/17(17:00)
2011,05,16,78235,70137,56752,13385,23.6,2011/05/16(17:00)
2011,05,15,78235,69873,49085,20788,42.4,2011/05/15(21:00)
2011,05,14,78235,69266,52212,17054,32.7,2011/05/14(11:00)
2011,05,13,78235,68985,56468,12517,22.2,2011/05/13(11:00)
2011,05,12,78235,69013,57456,11557,20.1,2011/05/12(15:00)
2011,05,11,78235,69157,58162,10995,18.9,2011/05/11(11:00)
2011,05,10,78235,69457,54245,15212,28,2011/05/10(21:00)
2011,05,09,78235,68605,57426,11179,19.5,2011/05/09(17:00)
2011,05,08,78235,67561,48844,18717,38.3,2011/05/08(23:00)
2011,05,07,78235,66544,53135,13409,25.2,2011/05/07(11:00)
2011,05,06,78235,66530,56584,9946,17.6,2011/05/06(20:00)
2011,05,05,78235,66350,53773,12577,23.4,2011/05/05(23:00)
2011,05,04,78235,66963,57261,9702,16.9,2011/05/04(11:00)
2011,05,03,78235,66710,57474,9236,16.1,2011/05/03(21:00)
2011,05,02,78235,66006,56616,9390,16.6,2011/05/02(20:00)
2011,05,01,78235,66695,49708,16987,34.2,2011/05/01(23:00)
2011,04,30,78235,65897,53761,12136,22.6,2011/04/30(11:00)
2011,04,29,78235,65899,57543,8356,14.5,2011/04/29(11:00)
2011,04,28,78235,65890,58727,7163,12.2,2011/04/28(11:00)
2011,04,27,78235,66431,58652,7779,13.3,2011/04/27(11:00)
2011,04,26,78235,66406,60417,5989,9.9,2011/04/26(11:00)
2011,04,25,78235,66395,58468,7927,13.6,2011/04/25(20:00)
2011,04,24,78235,64752,51836,12916,24.9,2011/04/24(23:00)
2011,04,23,78235,64282,54022,10260,19,2011/04/23(23:00)
2011,04,22,78235,67001,60413,6588,10.9,2011/04/22(11:00)
2011,04,21,78235,67028,58567,8461,14.4,2011/04/21(20:00)
2011,04,20,78235,67043,57945,9098,15.7,2011/04/20(11:00)
2011,04,19,78235,67578,59288,8290,14,2011/04/19(20:00)
2011,04,18,78235,67501,60491,7010,11.6,2011/04/18(11:00)
2011,04,17,78235,67772,51060,16712,32.7,2011/04/17(23:00)
2011,04,16,78235,67878,53422,14456,27.1,2011/04/16(11:00)
2011,04,15,78235,67364,58213,9151,15.7,2011/04/15(20:00)
2011,04,14,78235,68393,58387,10006,17.1,2011/04/14(11:00)
2011,04,13,78235,68429,58167,10262,17.6,2011/04/13(11:00)
2011,04,12,78235,69198,58278,10920,18.7,2011/04/12(20:00)
2011,04,11,78235,69198,59317,9881,16.7,2011/04/11(20:00)
2011,04,10,78235,68164,51540,16624,32.3,2011/04/10(23:00)
2011,04,09,78235,67462,54158,13304,24.6,2011/04/09(23:00)
2011,04,08,78235,70394,58990,11404,19.3,2011/04/08(11:00)
2011,04,07,78235,70371,61400,8971,14.6,2011/04/07(11:00)
2011,04,06,78235,70353,59749,10604,17.7,2011/04/06(11:00)
2011,04,05,78235,70846,59513,11333,19,2011/04/05(20:00)
2011,04,04,78235,70202,60148,10054,16.7,2011/04/04(20:00)
2011,04,03,78235,69094,52487,16607,31.6,2011/04/03(23:00)
2011,04,02,78235,69181,55482,13699,24.7,2011/04/02(11:00)
2011,04,01,78235,69733,59252,10481,17.7,2011/04/01(11:00)
2011,03,31,78235,69709,60600,9109,15,2011/03/31(10:00)
2011,03,30,78235,70092,61571,8521,13.8,2011/03/30(10:00)
2011,03,29,78235,69637,63256,6381,10.1,2011/03/29(11:00)
2011,03,28,78235,70021,62884,7137,11.3,2011/03/28(11:00)
2011,03,27,78235,68950,53874,15076,28,2011/03/27(23:00)
2011,03,26,78235,68950,57412,11538,20.1,2011/03/26(11:00)
2011,03,25,78235,70293,64447,5846,9.1,2011/03/25(11:00)
2011,03,24,78235,69663,63658,6005,9.4,2011/03/24(20:00)
2011,03,23,78235,70522,64073,6449,10.1,2011/03/23(11:00)
2011,03,22,78235,69867,63654,6213,9.8,2011/03/22(20:00)
2011,03,21,78235,70000,61855,8145,13.2,2011/03/21(11:00)
2011,03,20,78235,70359,53881,16478,30.6,2011/03/20(23:00)
2011,03,19,78235,69988,57109,12879,22.6,2011/03/19(11:00)
2011,03,18,78235,70766,64124,6642,10.4,2011/03/18(10:00)
2011,03,17,78235,70766,65740,5026,7.6,2011/03/17(11:00)
2011,03,16,78235,70669,65532,5137,7.8,2011/03/16(11:00)
2011,03,15,78235,70834,64101,6733,10.5,2011/03/15(20:00)
2011,03,14,78235,70626,62730,7896,12.6,2011/03/14(11:00)
2011,03,13,78235,70301,53341,16960,31.8,2011/03/13(23:00)
2011,03,12,78235,69160,57908,11252,19.4,2011/03/12(11:00)
2011,03,11,78235,71794,64038,7756,12.1,2011/03/11(10:00)
2011,03,10,78235,71269,66221,5048,7.6,2011/03/10(11:00)
2011,03,09,78235,71619,65762,5857,8.9,2011/03/09(11:00)
2011,03,08,78235,71499,65497,6002,9.2,2011/03/08(11:00)
2011,03,07,78235,71237,65700,5537,8.4,2011/03/07(11:00)
2011,03,06,78235,70323,55736,14587,26.2,2011/03/06(01:00)
2011,03,05,78235,70323,61100,9223,15.1,2011/03/05(11:00)
2011,03,04,78235,72432,67320,5112,7.6,2011/03/04(11:00)
2011,03,03,78235,72173,67310,4863,7.2,2011/03/03(11:00)
2011,03,02,77235,71183,66746,4437,6.6,2011/03/02(11:00)
2011,03,01,77235,71681,60454,11227,18.6,2011/03/01(24:00)
2011,02,28,77235,71826,65290,6536,10,2011/02/28(11:00)
2011,02,27,77235,72609,55444,17165,31,2011/02/27(24:00)
2011,02,26,77235,72225,58402,13823,23.7,2011/02/26(11:00)
2011,02,25,77235,75939,64032,11907,18.6,2011/02/25(11:00)
2011,02,24,76649,74041,63250,10791,17.1,2011/02/24(10:00)
2011,02,23,76649,73969,64759,9210,14.2,2011/02/23(10:00)
2011,02,22,76649,73121,64954,8167,12.6,2011/02/22(10:00)
2011,02,21,76649,73298,65622,7676,11.7,2011/02/21(11:00)
2011,02,20,76649,73843,57482,16361,28.5,2011/02/20(01:00)
2011,02,19,76649,73843,61327,12516,20.4,2011/02/19(11:00)
2011,02,18,76649,74624,67796,6828,10.1,2011/02/18(11:00)
2011,02,17,76649,75664,68750,6914,10.1,2011/02/17(11:00)
2011,02,16,76649,75367,69763,5604,8,2011/02/16(11:00)
2011,02,15,76649,76252,69913,6339,9.1,2011/02/15(11:00)
2011,02,14,76649,75729,71002,4727,6.7,2011/02/14(11:00)
2011,02,13,76649,75607,60087,15520,25.8,2011/02/13(01:00)
2011,02,12,76649,74682,63786,10896,17.1,2011/02/12(11:00)
2011,02,11,76649,77220,69597,7623,11,2011/02/11(11:00)
2011,02,10,76649,77439,70087,7352,10.5,2011/02/10(11:00)
2011,02,09,76649,76919,67876,9043,13.3,2011/02/09(11:00)
2011,02,08,76649,76452,68791,7661,11.1,2011/02/08(11:00)
2011,02,07,76649,76839,68498,8341,12.2,2011/02/07(11:00)
2011,02,06,76649,76780,57142,19638,34.4,2011/02/06(24:00)
2011,02,05,76649,76602,55570,21032,37.8,2011/02/05(24:00)
2011,02,04,76649,77676,52817,24859,47.1,2011/02/04(24:00)
2011,02,03,76649,79021,50796,28225,55.6,2011/02/03(24:00)
2011,02,02,76649,78597,58340,20257,34.7,2011/02/02(01:00)
2011,02,01,76649,78294,67396,10898,16.2,2011/02/01(11:00)
2011,01,31,76649,76972,71555,5417,7.6,2011/01/31(12:00)
2011,01,30,76649,76673,64028,12645,19.7,2011/01/30(24:00)
2011,01,29,76649,76763,66813,9950,14.9,2011/01/29(12:00)
2011,01,28,76649,77422,72274,5148,7.1,2011/01/28(11:00)
2011,01,27,76131,77422,73014,4408,6,2011/01/27(12:00)
2011,01,26,76131,77422,72292,5130,7.1,2011/01/26(11:00)
2011,01,25,76131,77090,72344,4746,6.6,2011/01/25(11:00)
2011,01,24,76131,77512,71913,5599,7.8,2011/01/24(12:00)
2011,01,23,76131,76968,62263,14705,23.6,2011/01/23(01:00)
2011,01,22,76131,76688,65505,11183,17.1,2011/01/22(12:00)
2011,01,21,76131,76298,71910,4388,6.1,2011/01/21(11:00)
2011,01,20,76131,76831,71918,4913,6.8,2011/01/20(12:00)
2011,01,19,76131,76865,72223,4642,6.4,2011/01/19(12:00)
2011,01,18,76131,76865,72433,4432,6.1,2011/01/18(11:00)
2011,01,17,76131,77179,73137,4042,5.5,2011/01/17(12:00)
2011,01,16,76131,75475,64446,11029,17.1,2011/01/16(01:00)
2011,01,15,76131,75475,66923,8552,12.8,2011/01/15(24:00)
2011,01,14,76131,76125,71569,4556,6.4,2011/01/14(11:00)
2011,01,13,76131,76201,71783,4418,6.2,2011/01/13(11:00)
2011,01,12,76131,76000,71785,4215,5.9,2011/01/12(12:00)
2011,01,11,76131,76000,71687,4313,6,2011/01/11(12:00)
2011,01,10,76131,75910,71840,4070,5.7,2011/01/10(12:00)
2011,01,09,76131,75239,61861,13378,21.6,2011/01/09(24:00)
2011,01,08,76131,74730,65100,9630,14.8,2011/01/08(11:00)
2011,01,07,76131,75931,71423,4508,6.3,2011/01/07(11:00)
2011,01,06,76131,76054,71285,4769,6.7,2011/01/06(19:00)
2011,01,05,76131,75160,70073,5087,7.3,2011/01/05(11:00)
2011,01,04,76131,75045,70869,4176,5.9,2011/01/04(11:00)
2011,01,03,76131,75170,70868,4302,6.1,2011/01/03(12:00)
2011,01,02,76078,75102,59173,15929,26.9,2011/01/02(24:00)
2011,01,01,76078,75003,59796,15207,25.4,2011/01/01(01:00)
2010,12,31,76078,75332,67331,8001,11.9,2010/12/31(11:00)
2010,12,30,76078,75631,69000,6631,9.6,2010/12/30(12:00)
2010,12,29,76078,75213,69708,5505,7.9,2010/12/29(11:00)
2010,12,28,76078,75184,70018,5166,7.4,2010/12/28(12:00)
2010,12,27,76078,75184,70107,5077,7.2,2010/12/27(12:00)
2010,12,26,76078,72246,60856,11390,18.7,2010/12/26(24:00)
2010,12,25,76078,73416,63874,9542,14.9,2010/12/25(01:00)
2010,12,24,76078,74312,69950,4362,6.2,2010/12/24(12:00)
2010,12,23,76078,73962,67320,6642,9.9,2010/12/23(19:00)
2010,12,22,76078,73441,66055,7386,11.2,2010/12/22(10:00)
2010,12,21,76078,74687,67445,7242,10.7,2010/12/21(11:00)
2010,12,20,76078,74551,66377,8174,12.3,2010/12/20(18:00)
2010,12,19,76078,71476,57830,13646,23.6,2010/12/19(01:00)
2010,12,18,76078,72660,62928,9732,15.5,2010/12/18(11:00)
2010,12,17,76078,75763,71060,4703,6.6,2010/12/17(11:00)
2010,12,16,76078,75752,71258,4494,6.3,2010/12/16(11:00)
2010,12,15,76078,75747,71308,4439,6.2,2010/12/15(18:00)
2010,12,14,76078,74371,69614,4757,6.8,2010/12/14(18:00)
2010,12,13,76078,73326,68739,4587,6.7,2010/12/13(11:00)
2010,12,12,76078,73283,57531,15752,27.4,2010/12/12(24:00)
2010,12,11,76078,73558,60423,13135,21.7,2010/12/11(24:00)
2010,12,10,76078,73975,67505,6470,9.6,2010/12/10(11:00)
2010,12,09,76078,73942,67817,6125,9,2010/12/09(18:00)
2010,12,08,76078,73573,67295,6278,9.3,2010/12/08(18:00)
2010,12,07,76078,72721,66728,5993,9,2010/12/07(18:00)
2010,12,06,76078,72430,65324,7106,10.9,2010/12/06(18:00)
2010,12,05,76078,72040,54345,17695,32.6,2010/12/05(01:00)
2010,12,04,76078,71960,59111,12849,21.7,2010/12/04(11:00)
2010,12,03,76078,72131,65414,6717,10.3,2010/12/03(18:00)
2010,12,02,76078,72137,62690,9447,15.1,2010/12/02(18:00)
2010,12,01,76078,71441,62842,8599,13.7,2010/12/01(11:00)
2010,11,30,75950,71431,63154,8277,13.1,2010/11/30(11:00)
2010,11,29,75950,71710,64984,6726,10.4,2010/11/29(11:00)
2010,11,28,75950,71622,55891,15731,28.1,2010/11/28(24:00)
2010,11,27,75950,70695,58710,11985,20.4,2010/11/27(11:00)
2010,11,26,75950,71410,64100,7310,11.4,2010/11/26(18:00)
2010,11,25,75950,71401,63802,7599,11.9,2010/11/25(19:00)
2010,11,24,75950,71467,61352,10115,16.5,2010/11/24(19:00)
2010,11,23,75950,71315,62576,8739,14,2010/11/23(19:00)
2010,11,22,75950,71197,62052,9145,14.7,2010/11/22(19:00)
2010,11,21,75950,70916,52209,18707,35.8,2010/11/21(23:00)
2010,11,20,75950,70072,56191,13881,24.7,2010/11/20(11:00)
2010,11,19,75950,70957,62270,8687,14,2010/11/19(11:00)
2010,11,18,75950,71034,62482,8552,13.7,2010/11/18(19:00)
2010,11,17,75950,71258,61785,9473,15.3,2010/11/17(10:00)
2010,11,16,75950,70958,63204,7754,12.3,2010/11/16(19:00)
2010,11,15,75950,70598,63009,7589,12,2010/11/15(19:00)
2010,11,14,75816,69385,52299,17086,32.7,2010/11/14(23:00)
2010,11,13,75816,69656,54292,15364,28.3,2010/11/13(11:00)
2010,11,12,75816,70319,60282,10037,16.7,2010/11/12(19:00)
2010,11,11,75816,70561,60749,9812,16.2,2010/11/11(19:00)
2010,11,10,75816,70421,60837,9584,15.8,2010/11/10(19:00)
2010,11,09,75816,69379,62623,6756,10.8,2010/11/09(19:00)
2010,11,08,75816,68504,61506,6998,11.4,2010/11/08(19:00)
2010,11,07,75816,68485,50906,17579,34.5,2010/11/07(23:00)
2010,11,06,75816,67841,53375,14466,27.1,2010/11/06(11:00)
2010,11,05,75816,67867,58874,8993,15.3,2010/11/05(19:00)
2010,11,04,75816,67048,60006,7042,11.7,2010/11/04(19:00)
2010,11,03,75816,66780,59648,7132,12,2010/11/03(19:00)
2010,11,02,75816,66577,60444,6133,10.1,2010/11/02(19:00)
2010,11,01,75816,66881,58325,8556,14.7,2010/11/01(19:00)
2010,10,31,75816,67248,50057,17191,34.3,2010/10/31(23:00)
2010,10,30,75816,65889,51919,13970,26.9,2010/10/30(23:00)
2010,10,29,75816,67129,58414,8715,14.9,2010/10/29(19:00)
2010,10,28,75712,66474,60003,6471,10.8,2010/10/28(19:00)
2010,10,27,75712,67067,59328,7739,13,2010/10/27(19:00)
2010,10,26,75712,67227,60330,6897,11.4,2010/10/26(19:00)
2010,10,25,75712,66551,58170,8381,14.4,2010/10/25(19:00)
2010,10,24,75712,65553,49157,16396,33.4,2010/10/24(23:00)
2010,10,23,75712,65465,50843,14622,28.8,2010/10/23(19:00)
2010,10,22,75712,65365,57184,8181,14.3,2010/10/22(19:00)
2010,10,21,75712,65312,58268,7044,12.1,2010/10/21(19:00)
2010,10,20,75712,65503,57494,8009,13.9,2010/10/20(19:00)
2010,10,19,75712,64649,58124,6525,11.2,2010/10/19(19:00)
2010,10,18,75712,64413,57601,6812,11.8,2010/10/18(19:00)
2010,10,17,75712,64647,48850,15797,32.3,2010/10/17(23:00)
2010,10,16,75712,63972,51213,12759,24.9,2010/10/16(19:00)
2010,10,15,75712,65087,57057,8030,14.1,2010/10/15(19:00)
2010,10,14,75712,66480,57818,8662,15,2010/10/14(19:00)
2010,10,13,75712,66453,57364,9089,15.8,2010/10/13(19:00)
2010,10,12,75712,66696,57712,8984,15.6,2010/10/12(19:00)
2010,10,11,75712,66687,57773,8914,15.4,2010/10/11(19:00)
2010,10,10,75712,67086,48332,18754,38.8,2010/10/10(20:00)
2010,10,09,75712,65585,50452,15133,30,2010/10/09(11:00)
2010,10,08,75712,66764,57084,9680,17,2010/10/08(19:00)
2010,10,07,75712,66599,57373,9226,16.1,2010/10/07(19:00)
2010,10,06,74407,67306,56475,10831,19.2,2010/10/06(20:00)
2010,10,05,74407,67170,56438,10732,19,2010/10/05(20:00)
2010,10,04,74407,66662,56515,10147,18,2010/10/04(19:00)
2010,10,03,74407,67125,48264,18861,39.1,2010/10/03(20:00)
2010,10,02,74407,67979,51865,16114,31.1,2010/10/02(12:00)
2010,10,01,74407,67372,55938,11434,20.4,2010/10/01(20:00)
2010,09,30,74407,67634,56247,11387,20.2,2010/09/30(20:00)
2010,09,29,74407,66313,55918,10395,18.6,2010/09/29(20:00)
2010,09,28,74407,66546,56040,10506,18.7,2010/09/28(20:00)
2010,09,27,74407,66591,56095,10496,18.7,2010/09/27(20:00)
2010,09,26,74407,67117,48466,18651,38.5,2010/09/26(20:00)
2010,09,25,74407,66293,48664,17629,36.2,2010/09/25(20:00)
2010,09,24,74407,66645,47132,19513,41.4,2010/09/24(20:00)
2010,09,23,74407,67264,41282,25982,62.9,2010/09/23(20:00)
2010,09,22,74407,67530,38764,28766,74.2,2010/09/22(23:00)
2010,09,21,74407,66730,45151,21579,47.8,2010/09/21(20:00)
2010,09,20,74407,67386,55804,11582,20.8,2010/09/20(12:00)
2010,09,19,74407,67132,52757,14375,27.2,2010/09/19(20:00)
2010,09,18,74407,67123,58479,8644,14.8,2010/09/18(15:00)
2010,09,17,74407,69600,63411,6189,9.8,2010/09/17(15:00)
2010,09,16,74407,69590,62644,6946,11.1,2010/09/16(15:00)
2010,09,15,74407,69590,62527,7063,11.3,2010/09/15(15:00)
2010,09,14,74407,70055,63188,6867,10.9,2010/09/14(15:00)
2010,09,13,74407,70055,62758,7297,11.6,2010/09/13(15:00)
2010,09,12,74407,69801,52039,17762,34.1,2010/09/12(20:00)
2010,09,11,74407,69792,58590,11202,19.1,2010/09/11(12:00)
2010,09,10,74407,70785,64312,6473,10.1,2010/09/10(15:00)
2010,09,09,74407,70785,60665,10120,16.7,2010/09/09(20:00)
2010,09,08,74407,70785,59598,11187,18.8,2010/09/08(12:00)
2010,09,07,74407,70502,63906,6596,10.3,2010/09/07(15:00)
2010,09,06,74407,70785,66362,4423,6.7,2010/09/06(15:00)
2010,09,05,74407,70040,54902,15138,27.6,2010/09/05(20:00)
2010,09,04,74407,70277,62239,8038,12.9,2010/09/04(15:00)
2010,09,03,74407,71936,67802,4134,6.1,2010/09/03(15:00)
2010,09,02,74407,72408,63901,8507,13.3,2010/09/02(17:00)
2010,09,01,74407,73054,68842,4212,6.1,2010/09/01(15:00)
2010,08,31,74407,73053,66242,6811,10.3,2010/08/31(15:00)
2010,08,30,74407,72728,67230,5498,8.2,2010/08/30(15:00)
2010,08,29,74407,73063,54204,18859,34.8,2010/08/29(20:00)
2010,08,28,74407,72038,59400,12638,21.3,2010/08/28(12:00)
2010,08,27,74407,73959,67781,6178,9.1,2010/08/27(15:00)
2010,08,26,74407,74579,66283,8296,12.5,2010/08/26(15:00)
2010,08,25,74407,74826,65140,9686,14.9,2010/08/25(12:00)
2010,08,24,74407,73966,66982,6984,10.4,2010/08/24(15:00)
2010,08,23,74407,73966,69404,4562,6.6,2010/08/23(15:00)
2010,08,22,74407,73110,58594,14516,24.8,2010/08/22(21:00)
2010,08,21,74407,73374,64327,9047,14.1,2010/08/21(15:00)
2010,08,20,74407,74344,69886,4458,6.4,2010/08/20(15:00)
2010,08,19,74407,73574,68493,5081,7.4,2010/08/19(15:00)
2010,08,18,74407,73574,67452,6122,9.1,2010/08/18(15:00)
2010,08,17,74407,73259,64676,8583,13.3,2010/08/17(15:00)
2010,08,16,74407,72421,63646,8775,13.8,2010/08/16(12:00)
2010,08,15,74407,72834,54015,18819,34.8,2010/08/15(21:00)
2010,08,14,74407,72521,58726,13795,23.5,2010/08/14(12:00)
2010,08,13,74407,73211,65504,7707,11.8,2010/08/13(15:00)
2010,08,12,74407,73569,63461,10108,15.9,2010/08/12(12:00)
2010,08,11,74407,72696,65206,7490,11.5,2010/08/11(17:00)
2010,08,10,74407,73569,65800,7769,11.8,2010/08/10(15:00)
2010,08,09,74407,73569,67287,6282,9.3,2010/08/09(15:00)
2010,08,08,74407,73103,54975,18128,33,2010/08/08(21:00)
2010,08,07,74407,73193,59045,14148,24,2010/08/07(12:00)
2010,08,06,74407,73820,65633,8187,12.5,2010/08/06(15:00)
2010,08,05,74407,73820,66609,7211,10.8,2010/08/05(15:00)
2010,08,04,74407,73820,62663,11157,17.8,2010/08/04(15:00)
2010,08,03,74407,73820,58086,15734,27.1,2010/08/03(15:00)
2010,08,02,74407,73559,58915,14644,24.9,2010/08/02(15:00)
2010,08,01,74407,72884,53946,18938,35.1,2010/08/01(21:00)
2010,07,31,74407,72301,54739,17562,32.1,2010/07/31(15:00)
2010,07,30,74407,73155,64812,8343,12.9,2010/07/30(15:00)
2010,07,29,74407,73270,66192,7078,10.7,2010/07/29(15:00)
2010,07,28,74407,73270,64904,8366,12.9,2010/07/28(15:00)
2010,07,27,74407,73270,67323,5947,8.8,2010/07/27(15:00)
2010,07,26,74407,73270,65445,7825,12,2010/07/26(15:00)
2010,07,25,74407,73815,53154,20661,38.9,2010/07/25(21:00)
2010,07,24,74407,72905,58717,14188,24.2,2010/07/24(15:00)
2010,07,23,74407,72742,63799,8943,14,2010/07/23(15:00)
2010,07,22,74407,73325,67619,5706,8.4,2010/07/22(15:00)
2010,07,21,74407,73815,66850,6965,10.4,2010/07/21(15:00)
2010,07,20,74407,73810,67008,6802,10.2,2010/07/20(15:00)
2010,07,19,74407,73810,65683,8127,12.4,2010/07/19(15:00)
2010,07,18,74407,72962,53048,19914,37.5,2010/07/18(21:00)
2010,07,17,74407,72067,56700,15367,27.1,2010/07/17(12:00)
2010,07,16,74407,71623,63439,8184,12.9,2010/07/16(15:00)
2010,07,15,74407,73358,64795,8563,13.2,2010/07/15(15:00)
2010,07,14,74407,73879,63985,9894,15.5,2010/07/14(15:00)
2010,07,13,74407,73868,63409,10459,16.5,2010/07/13(15:00)
2010,07,12,74407,73805,62649,11156,17.8,2010/07/12(15:00)
2010,07,11,74407,71918,50322,21596,42.9,2010/07/11(21:00)
2010,07,10,74407,72026,56927,15099,26.5,2010/07/10(12:00)
2010,07,09,74407,72953,63904,9049,14.2,2010/07/09(15:00)
2010,07,08,74407,72801,63493,9308,14.7,2010/07/08(15:00)
2010,07,07,74407,71285,64839,6446,9.9,2010/07/07(15:00)
2010,07,06,74407,71849,65025,6824,10.5,2010/07/06(15:00)
2010,07,05,74407,72195,64587,7608,11.8,2010/07/05(15:00)
2010,07,04,74407,72006,52044,19962,38.4,2010/07/04(21:00)
2010,07,03,74407,71769,56545,15224,26.9,2010/07/03(15:00)
2010,07,02,74407,72728,63277,9451,14.9,2010/07/02(15:00)
2010,07,01,74407,72754,63274,9480,15,2010/07/01(15:00)
2010,06,30,74407,72763,62044,10719,17.3,2010/06/30(15:00)
2010,06,29,74407,72343,62699,9644,15.4,2010/06/29(15:00)
2010,06,28,74407,72153,61810,10343,16.7,2010/06/28(15:00)
2010,06,27,74407,70617,49412,21205,42.9,2010/06/27(21:00)
2010,06,26,74407,71488,54224,17264,31.8,2010/06/26(12:00)
2010,06,25,74407,71565,62828,8737,13.9,2010/06/25(15:00)
2010,06,24,74407,71288,62130,9158,14.7,2010/06/24(15:00)
2010,06,23,74407,71246,60629,10617,17.5,2010/06/23(15:00)
2010,06,22,74407,71396,60265,11131,18.5,2010/06/22(15:00)
2010,06,21,74407,71088,61058,10030,16.4,2010/06/21(17:00)
2010,06,20,74407,70076,49737,20339,40.9,2010/06/20(21:00)
2010,06,19,74407,70626,54962,15664,28.5,2010/06/19(12:00)
2010,06,18,74407,70465,62545,7920,12.7,2010/06/18(15:00)
2010,06,17,74407,70005,62269,7736,12.4,2010/06/17(15:00)
2010,06,16,74407,69734,60091,9643,16,2010/06/16(15:00)
2010,06,15,74407,68403,61656,6747,10.9,2010/06/15(15:00)
2010,06,14,74407,68009,59693,8316,13.9,2010/06/14(15:00)
2010,06,13,74407,67481,49237,18244,37.1,2010/06/13(21:00)
2010,06,12,74407,67486,52380,15106,28.8,2010/06/12(12:00)
2010,06,11,74407,67509,60497,7012,11.6,2010/06/11(15:00)
2010,06,10,74407,67316,61464,5852,9.5,2010/06/10(15:00)
2010,06,09,74407,67054,60564,6490,10.7,2010/06/09(15:00)
2010,06,08,74407,66771,59341,7430,12.5,2010/06/08(17:00)
2010,06,07,74407,66816,59364,7452,12.6,2010/06/07(15:00)
2010,06,06,74407,65986,48278,17708,36.7,2010/06/06(21:00)
2010,06,05,74407,65237,52282,12955,24.8,2010/06/05(12:00)
2010,06,04,74407,65463,57021,8442,14.8,2010/06/04(15:00)
2010,06,03,74407,65557,56224,9333,16.6,2010/06/03(17:00)
2010,06,02,74407,66353,51954,14399,27.7,2010/06/02(21:00)
2010,06,01,74407,64558,54197,10361,19.1,2010/06/01(17:00)
2010,05,31,74407,64018,53838,10180,18.9,2010/05/31(15:00)
2010,05,30,74407,63879,46909,16970,36.2,2010/05/30(21:00)
2010,05,29,74407,63715,50137,13578,27.1,2010/05/29(12:00)
2010,05,28,74407,64507,54403,10104,18.6,2010/05/28(15:00)
2010,05,27,74407,64476,54253,10223,18.8,2010/05/27(21:00)
2010,05,26,74407,64079,54148,9931,18.3,2010/05/26(15:00)
2010,05,25,74407,63713,54352,9361,17.2,2010/05/25(11:00)
2010,05,24,74407,64376,54076,10300,19,2010/05/24(15:00)
2010,05,23,73673,65243,46849,18394,39.3,2010/05/23(23:00)
2010,05,22,73673,64564,48959,15605,31.9,2010/05/22(12:00)
2010,05,21,73673,65652,51089,14563,28.5,2010/05/21(21:00)
2010,05,20,73673,65579,55393,10186,18.4,2010/05/20(15:00)
2010,05,19,73673,64952,54308,10644,19.6,2010/05/19(15:00)
2010,05,18,73673,65153,55244,9909,17.9,2010/05/18(15:00)
2010,05,17,73673,64872,54482,10390,19.1,2010/05/17(15:00)
2010,05,16,73673,64832,46502,18330,39.4,2010/05/16(21:00)
2010,05,15,73673,63466,49725,13741,27.6,2010/05/15(11:00)
2010,05,14,73673,63917,53540,10377,19.4,2010/05/14(15:00)
2010,05,13,73673,64167,53707,10460,19.5,2010/05/13(21:00)
2010,05,12,73673,63467,53564,9903,18.5,2010/05/12(12:00)
2010,05,11,73673,63467,54209,9258,17.1,2010/05/11(21:00)
2010,05,10,73673,63967,53919,10048,18.6,2010/05/10(21:00)
2010,05,09,73673,64822,46677,18145,38.9,2010/05/09(21:00)
2010,05,08,73673,64308,49220,15088,30.7,2010/05/08(11:00)
2010,05,07,73673,64288,53512,10776,20.1,2010/05/07(11:00)
2010,05,06,73673,64845,54703,10142,18.5,2010/05/06(20:00)
2010,05,05,73673,64866,50631,14235,28.1,2010/05/05(21:00)
2010,05,04,73673,65002,54128,10874,20.1,2010/05/04(20:00)
2010,05,03,73673,65147,54328,10819,19.9,2010/05/03(20:00)
2010,05,02,73673,65730,47824,17906,37.4,2010/05/02(23:00)
2010,05,01,73673,66373,49267,17106,34.7,2010/05/01(01:00)
2010,04,30,73673,66437,55018,11419,20.8,2010/04/30(11:00)
2010,04,29,73673,66532,56313,10219,18.1,2010/04/29(11:00)
2010,04,28,73673,65956,58766,7190,12.2,2010/04/28(15:00)
2010,04,27,73673,64426,56387,8039,14.3,2010/04/27(20:00)
2010,04,26,73673,65997,56083,9914,17.7,2010/04/26(20:00)
2010,04,25,73673,65955,48521,17434,35.9,2010/04/25(23:00)
2010,04,24,73673,65635,51033,14602,28.6,2010/04/24(23:00)
2010,04,23,73673,66660,55370,11290,20.4,2010/04/23(11:00)
2010,04,22,73673,66539,56553,9986,17.7,2010/04/22(11:00)
2010,04,21,73673,66163,55520,10643,19.2,2010/04/21(20:00)
2010,04,20,73673,66163,55078,11085,20.1,2010/04/20(20:00)
2010,04,19,73673,66281,55814,10467,18.8,2010/04/19(20:00)
2010,04,18,73673,66110,49721,16389,33,2010/04/18(23:00)
2010,04,17,73673,65931,52212,13719,26.3,2010/04/17(24:00)
2010,04,16,73673,64676,56590,8086,14.3,2010/04/16(11:00)
2010,04,15,73673,64862,58131,6731,11.6,2010/04/15(11:00)
2010,04,14,73673,64619,58304,6315,10.8,2010/04/14(20:00)
2010,04,13,73673,64537,58181,6356,10.9,2010/04/13(20:00)
2010,04,12,73673,64150,56017,8133,14.5,2010/04/12(11:00)
2010,04,11,73673,64719,48636,16083,33.1,2010/04/11(23:00)
2010,04,10,73470,64640,51203,13437,26.2,2010/04/10(11:00)
2010,04,09,73470,64561,55600,8961,16.1,2010/04/09(11:00)
2010,04,08,73470,65348,56916,8432,14.8,2010/04/08(11:00)
2010,04,07,73470,65116,56624,8492,15,2010/04/07(20:00)
2010,04,06,73470,64654,56978,7676,13.5,2010/04/06(11:00)
2010,04,05,73470,64464,55671,8793,15.8,2010/04/05(20:00)
2010,04,04,73470,63672,50063,13609,27.2,2010/04/04(23:00)
2010,04,03,73470,63738,53429,10309,19.3,2010/04/03(24:00)
2010,04,02,73470,65878,57662,8216,14.2,2010/04/02(11:00)
2010,04,01,73470,66370,58130,8240,14.2,2010/04/01(11:00)
2010,03,31,73470,66092,59738,6354,10.6,2010/03/31(11:00)
2010,03,30,73470,66887,58949,7938,13.5,2010/03/30(11:00)
2010,03,29,73470,66169,58571,7598,13,2010/03/29(11:00)
2010,03,28,73470,65767,51532,14235,27.6,2010/03/28(23:00)
2010,03,27,73470,66048,54334,11714,21.6,2010/03/27(11:00)
2010,03,26,73470,67762,60478,7284,12,2010/03/26(11:00)
2010,03,25,73470,67308,60204,7104,11.8,2010/03/25(20:00)
2010,03,24,73470,66934,58629,8305,14.2,2010/03/24(11:00)
2010,03,23,73470,67187,61085,6102,10,2010/03/23(11:00)
2010,03,22,73470,67457,61342,6115,10,2010/03/22(17:00)
2010,03,21,73470,68240,52065,16175,31.1,2010/03/21(23:00)
2010,03,20,73470,67548,54215,13333,24.6,2010/03/20(24:00)
2010,03,19,73470,67228,60987,6241,10.2,2010/03/19(11:00)
2010,03,18,73470,67441,61895,5546,9,2010/03/18(11:00)
2010,03,17,73470,67364,60693,6671,11,2010/03/17(11:00)
2010,03,16,73470,67329,60522,6807,11.2,2010/03/16(11:00)
2010,03,15,73470,66977,59614,7363,12.4,2010/03/15(11:00)
2010,03,14,73470,65855,51175,14680,28.7,2010/03/14(01:00)
2010,03,13,73470,66136,54685,11451,20.9,2010/03/13(11:00)
2010,03,12,73470,68437,60238,8199,13.6,2010/03/12(11:00)
2010,03,11,73470,68510,61714,6796,11,2010/03/11(11:00)
2010,03,10,73470,68648,63520,5128,8.1,2010/03/10(11:00)
2010,03,09,73470,68115,61719,6396,10.4,2010/03/09(11:00)
2010,03,08,73470,68264,60869,7395,12.1,2010/03/08(11:00)
2010,03,07,73470,67141,52649,14492,27.5,2010/03/07(24:00)
2010,03,06,73470,67090,54973,12117,22,2010/03/06(24:00)
2010,03,05,73470,69019,59940,9079,15.1,2010/03/05(11:00)
2010,03,04,73470,69390,60678,8712,14.4,2010/03/04(12:00)
2010,03,03,73470,69378,60567,8811,14.5,2010/03/03(11:00)
2010,03,02,73470,69389,61058,8331,13.6,2010/03/02(11:00)
2010,03,01,73470,68719,54174,14545,26.8,2010/03/01(24:00)
2010,02,28,73470,68404,50703,17701,34.9,2010/02/28(24:00)
2010,02,27,73470,68945,53514,15431,28.8,2010/02/27(24:00)
2010,02,26,73470,69847,57875,11972,20.7,2010/02/26(12:00)
2010,02,25,73470,69285,58443,10842,18.6,2010/02/25(12:00)
2010,02,24,73470,69368,58871,10497,17.8,2010/02/24(11:00)
2010,02,23,73470,70136,60745,9391,15.5,2010/02/23(11:00)
2010,02,22,73470,70184,62072,8112,13.1,2010/02/22(11:00)
2010,02,21,73470,69099,53941,15158,28.1,2010/02/21(01:00)
2010,02,20,73470,69646,57670,11976,20.8,2010/02/20(11:00)
2010,02,19,73470,70957,64530,6427,10,2010/02/19(11:00)
2010,02,18,73470,71077,64717,6360,9.8,2010/02/18(11:00)
2010,02,17,73470,70591,63991,6600,10.3,2010/02/17(11:00)
2010,02,16,73470,71097,56551,14546,25.7,2010/02/16(24:00)
2010,02,15,73470,71807,51038,20769,40.7,2010/02/15(24:00)
2010,02,14,73470,72433,48762,23671,48.5,2010/02/14(24:00)
2010,02,13,73470,72725,53947,18778,34.8,2010/02/13(01:00)
2010,02,12,73470,73173,62160,11013,17.7,2010/02/12(11:00)
2010,02,11,73470,73126,64432,8694,13.5,2010/02/11(12:00)
2010,02,10,73470,73117,63648,9469,14.9,2010/02/10(11:00)
2010,02,09,73470,73196,64692,8504,13.1,2010/02/09(11:00)
2010,02,08,73470,73594,65554,8040,12.3,2010/02/08(11:00)
2010,02,07,73470,73160,56968,16192,28.4,2010/02/07(01:00)
2010,02,06,73470,73400,60583,12817,21.2,2010/02/06(11:00)
2010,02,05,73470,73400,66347,7053,10.6,2010/02/05(11:00)
2010,02,04,73470,73400,66878,6522,9.8,2010/02/04(11:00)
2010,02,03,73470,73013,67158,5855,8.7,2010/02/03(11:00)
2010,02,02,73470,73290,65362,7928,12.1,2010/02/02(11:00)
2010,02,01,73470,72520,64747,7773,12,2010/02/01(11:00)
2010,01,31,73470,73570,54660,18910,34.6,2010/01/31(24:00)
2010,01,30,73470,73965,58093,15872,27.3,2010/01/30(11:00)
2010,01,29,73470,73980,65033,8947,13.8,2010/01/29(11:00)
2010,01,28,73470,73730,63737,9993,15.7,2010/01/28(11:00)
2010,01,27,73470,73990,65585,8405,12.8,2010/01/27(11:00)
2010,01,26,73470,74520,66754,7766,11.6,2010/01/26(11:00)
2010,01,25,73470,74410,65677,8733,13.3,2010/01/25(19:00)
2010,01,24,73470,74651,56835,17816,31.3,2010/01/24(01:00)
2010,01,23,73470,74292,59704,14588,24.4,2010/01/23(24:00)
2010,01,22,73470,74651,66357,8294,12.5,2010/01/22(11:00)
2010,01,21,73470,73750,64783,8967,13.8,2010/01/21(19:00)
2010,01,20,73470,73687,63608,10079,15.8,2010/01/20(11:00)
2010,01,19,73470,73627,66095,7532,11.4,2010/01/19(11:00)
2010,01,18,73470,73018,67347,5671,8.4,2010/01/18(11:00)
2010,01,17,73470,72987,58140,14847,25.5,2010/01/17(01:00)
2010,01,16,73470,73621,61076,12545,20.5,2010/01/16(01:00)
2010,01,15,73470,73454,68539,4915,7.2,2010/01/15(11:00)
2010,01,14,73470,74014,68937,5077,7.4,2010/01/14(11:00)
2010,01,13,73470,73722,68963,4759,6.9,2010/01/13(12:00)
2010,01,12,73470,72957,68758,4199,6.1,2010/01/12(11:00)
2010,01,11,73470,73430,68372,5058,7.4,2010/01/11(12:00)
2010,01,10,73470,73604,57900,15704,27.1,2010/01/10(01:00)
2010,01,09,73470,72328,61277,11051,18,2010/01/09(12:00)
2010,01,08,73470,72963,68555,4408,6.4,2010/01/08(11:00)
2010,01,07,73470,72963,68273,4690,6.9,2010/01/07(11:00)
2010,01,06,73470,72580,67855,4725,7,2010/01/06(12:00)
2010,01,05,73470,72770,66901,5869,8.8,2010/01/05(18:00)
2010,01,04,73470,72688,66149,6539,9.9,2010/01/04(12:00)
2010,01,03,73470,71958,55581,16377,29.5,2010/01/03(24:00)
2010,01,02,73470,71953,55470,16483,29.7,2010/01/02(24:00)
2010,01,01,73470,72003,56391,15612,27.7,2010/01/01(01:00)
2009,12,31,73470,72336,63023,9313,14.8,2009/12/31(11:00)
2009,12,30,73470,72344,64103,8241,12.9,2009/12/30(12:00)
2009,12,29,73470,71569,66175,5394,8.2,2009/12/29(11:00)
2009,12,28,73470,71109,66250,4859,7.3,2009/12/28(18:00)
2009,12,27,73470,71100,56908,14192,24.9,2009/12/27(24:00)
2009,12,26,73470,70900,57698,13202,22.9,2009/12/26(24:00)
2009,12,25,73470,71335,56855,14480,25.5,2009/12/25(24:00)
2009,12,24,73470,70343,63089,7254,11.5,2009/12/24(11:00)
2009,12,23,73310,70390,62605,7785,12.4,2009/12/23(11:00)
2009,12,22,73310,70589,64988,5601,8.6,2009/12/22(11:00)
2009,12,21,73310,70883,66430,4453,6.7,2009/12/21(18:00)
2009,12,20,73310,70303,57317,12986,22.7,2009/12/20(01:00)
2009,12,19,73310,70195,60368,9827,16.3,2009/12/19(12:00)
2009,12,18,73310,72071,66797,5274,7.9,2009/12/18(18:00)
2009,12,17,73310,71641,66619,5022,7.5,2009/12/17(18:00)
2009,12,16,73310,71416,65438,5978,9.1,2009/12/16(18:00)
2009,12,15,73310,71821,64991,6830,10.5,2009/12/15(18:00)
2009,12,14,73310,71821,63035,8786,13.9,2009/12/14(18:00)
2009,12,13,73310,71414,53008,18406,34.7,2009/12/13(24:00)
2009,12,12,73310,70783,54639,16144,29.5,2009/12/12(24:00)
2009,12,11,73310,71446,60076,11370,18.9,2009/12/11(18:00)
2009,12,10,73310,71604,61752,9852,16,2009/12/10(18:00)
2009,12,09,73310,71683,62766,8917,14.2,2009/12/09(11:00)
2009,12,08,73310,71647,63512,8135,12.8,2009/12/08(18:00)
2009,12,07,73310,71372,63292,8080,12.8,2009/12/07(18:00)
2009,12,06,73310,71393,54280,17113,31.5,2009/12/06(24:00)
2009,12,05,73310,71104,56513,14591,25.8,2009/12/05(24:00)
2009,12,04,73310,71103,60150,10953,18.2,2009/12/04(10:00)
2009,12,03,73310,71263,61007,10256,16.8,2009/12/03(18:00)
2009,12,02,73310,71287,59689,11598,19.4,2009/12/02(11:00)
2009,12,01,73310,71416,59636,11780,19.8,2009/12/01(18:00)
2009,11,30,73310,71426,59776,11650,19.5,2009/11/30(19:00)
2009,11,29,73310,70975,51347,19628,38.2,2009/11/29(24:00)
2009,11,28,73310,71166,53523,17643,33,2009/11/28(24:00)
2009,11,27,73310,71075,59078,11997,20.3,2009/11/27(18:00)
2009,11,26,73310,71184,59278,11906,20.1,2009/11/26(19:00)
2009,11,25,73310,71269,60453,10816,17.9,2009/11/25(11:00)
2009,11,24,73146,71178,59548,11630,19.5,2009/11/24(19:00)
2009,11,23,73146,70886,60295,10591,17.6,2009/11/23(19:00)
2009,11,22,73146,68658,52517,16141,30.7,2009/11/22(01:00)
2009,11,21,73146,68554,55343,13211,23.9,2009/11/21(24:00)
2009,11,20,73146,68809,61513,7296,11.9,2009/11/20(11:00)
2009,11,19,73146,69286,61375,7911,12.9,2009/11/19(19:00)
2009,11,18,73146,69092,61941,7151,11.5,2009/11/18(11:00)
2009,11,17,73146,68901,62315,6586,10.6,2009/11/17(19:00)
2009,11,16,73146,68117,61843,6274,10.1,2009/11/16(18:00)
2009,11,15,73146,68150,51343,16807,32.7,2009/11/15(24:00)
2009,11,14,73146,68903,52533,16370,31.2,2009/11/14(24:00)
2009,11,13,73146,68868,56464,12404,22,2009/11/13(19:00)
2009,11,12,73146,68868,56798,12070,21.3,2009/11/12(19:00)
2009,11,11,73146,68490,56084,12406,22.1,2009/11/11(19:00)
2009,11,10,73146,68228,56032,12196,21.8,2009/11/10(19:00)
2009,11,09,73146,68283,55501,12782,23,2009/11/09(19:00)
2009,11,08,73146,68177,47440,20737,43.7,2009/11/08(23:00)
2009,11,07,73146,66997,48893,18104,37,2009/11/07(19:00)
2009,11,06,73146,66997,55063,11934,21.7,2009/11/06(19:00)
2009,11,05,73146,66988,55675,11313,20.3,2009/11/05(19:00)
2009,11,04,73146,65939,56250,9689,17.2,2009/11/04(19:00)
2009,11,03,73146,66463,58414,8049,13.8,2009/11/03(19:00)
2009,11,02,73146,65484,57910,7574,13.1,2009/11/02(19:00)
2009,11,01,73146,63811,46865,16946,36.2,2009/11/01(23:00)
2009,10,31,73146,64321,48315,16006,33.1,2009/10/31(19:00)
2009,10,30,73146,65638,54501,11137,20.4,2009/10/30(19:00)
2009,10,29,73146,65535,55012,10523,19.1,2009/10/29(19:00)
2009,10,28,73146,66470,54582,11888,21.8,2009/10/28(19:00)
2009,10,27,73146,67255,55103,12152,22.1,2009/10/27(19:00)
2009,10,26,73146,67255,54954,12301,22.4,2009/10/26(19:00)
2009,10,25,73146,66261,46506,19755,42.5,2009/10/25(23:00)
2009,10,24,73146,65211,48221,16990,35.2,2009/10/24(19:00)
2009,10,23,73146,67509,54448,13061,24,2009/10/23(19:00)
2009,10,22,73146,67487,55068,12419,22.6,2009/10/22(19:00)
2009,10,21,73146,66967,54101,12866,23.8,2009/10/21(19:00)
2009,10,20,73146,67205,54543,12662,23.2,2009/10/20(19:00)
2009,10,19,73146,67205,54576,12629,23.1,2009/10/19(19:00)
2009,10,18,73146,65423,46121,19302,41.9,2009/10/18(23:00)
2009,10,17,73146,65846,48159,17687,36.7,2009/10/17(19:00)
2009,10,16,73146,66196,54176,12020,22.2,2009/10/16(19:00)
2009,10,15,73146,66327,54511,11816,21.7,2009/10/15(19:00)
2009,10,14,73146,66627,53812,12815,23.8,2009/10/14(19:00)
2009,10,13,73146,66039,54584,11455,21,2009/10/13(19:00)
2009,10,12,73146,66398,54006,12392,22.9,2009/10/12(19:00)
2009,10,11,73146,66784,46152,20632,44.7,2009/10/11(20:00)
2009,10,10,73146,66522,48378,18144,37.5,2009/10/10(20:00)
2009,10,09,73146,68332,53558,14774,27.6,2009/10/09(19:00)
2009,10,08,73146,67491,53914,13577,25.2,2009/10/08(19:00)
2009,10,07,73146,67491,53223,14268,26.8,2009/10/07(19:00)
2009,10,06,73146,68264,52468,15796,30.1,2009/10/06(20:00)
2009,10,05,73146,67440,46447,20993,45.2,2009/10/05(20:00)
2009,10,04,73146,68090,39607,28483,71.9,2009/10/04(20:00)
2009,10,03,73146,68090,37110,30980,83.5,2009/10/03(23:00)
2009,10,02,73146,68090,40891,27199,66.5,2009/10/02(01:00)
2009,10,01,73146,68493,51529,16964,32.9,2009/10/01(12:00)
2009,09,30,73372,69747,55410,14337,25.9,2009/09/30(15:00)
2009,09,29,73372,69374,55733,13641,24.5,2009/09/29(20:00)
2009,09,28,73372,69374,55590,13784,24.8,2009/09/28(20:00)
2009,09,27,73372,68378,47568,20810,43.7,2009/09/27(20:00)
2009,09,26,73372,68824,50805,18019,35.5,2009/09/26(15:00)
2009,09,25,73372,69003,55228,13775,24.9,2009/09/25(15:00)
2009,09,24,73372,68310,55939,12371,22.1,2009/09/24(20:00)
2009,09,23,73372,67839,55676,12163,21.8,2009/09/23(16:00)
2009,09,22,73372,68331,55412,12919,23.3,2009/09/22(20:00)
2009,09,21,73372,67827,55221,12606,22.8,2009/09/21(16:00)
2009,09,20,73372,66489,46946,19543,41.6,2009/09/20(20:00)
2009,09,19,73372,65822,50143,15679,31.3,2009/09/19(15:00)
2009,09,18,73372,68053,56575,11478,20.3,2009/09/18(15:00)
2009,09,17,73372,68053,55850,12203,21.8,2009/09/17(20:00)
2009,09,16,73372,67363,55970,11393,20.4,2009/09/16(15:00)
2009,09,15,73372,67611,55619,11992,21.6,2009/09/15(20:00)
2009,09,14,73372,67611,55318,12293,22.2,2009/09/14(20:00)
2009,09,13,73372,65799,47118,18681,39.6,2009/09/13(20:00)
2009,09,12,73372,66462,50159,16303,32.5,2009/09/12(12:00)
2009,09,11,73372,67882,56799,11083,19.5,2009/09/11(15:00)
2009,09,10,73372,68185,58242,9943,17.1,2009/09/10(15:00)
2009,09,09,73372,67750,59138,8612,14.6,2009/09/09(15:00)
2009,09,08,73372,66557,59386,7171,12.1,2009/09/08(15:00)
2009,09,07,73372,67097,60624,6473,10.7,2009/09/07(15:00)
2009,09,06,73372,66109,49616,16493,33.2,2009/09/06(20:00)
2009,09,05,73372,65528,53402,12126,22.7,2009/09/05(15:00)
2009,09,04,73372,67845,58476,9369,16,2009/09/04(15:00)
2009,09,03,73372,68106,58194,9912,17,2009/09/03(15:00)
2009,09,02,73372,68106,57800,10306,17.8,2009/09/02(15:00)
2009,09,01,73372,68213,57233,10980,19.2,2009/09/01(15:00)
2009,08,31,73372,70362,56461,13901,24.6,2009/08/31(15:00)
2009,08,30,73372,69216,46285,22931,49.5,2009/08/30(21:00)
2009,08,29,73372,69126,51791,17335,33.5,2009/08/29(12:00)
2009,08,28,73372,70764,61414,9350,15.2,2009/08/28(15:00)
2009,08,27,73372,70690,60444,10246,17,2009/08/27(15:00)
2009,08,26,73372,71070,60319,10751,17.8,2009/08/26(15:00)
2009,08,25,73372,71070,60971,10099,16.6,2009/08/25(15:00)
2009,08,24,73372,71070,61245,9825,16,2009/08/24(15:00)
2009,08,23,73372,70013,49661,20352,41,2009/08/23(21:00)
2009,08,22,73372,70295,53552,16743,31.3,2009/08/22(15:00)
2009,08,21,73372,72990,60753,12237,20.1,2009/08/21(15:00)
2009,08,20,73372,72990,62753,10237,16.3,2009/08/20(15:00)
2009,08,19,73372,72632,63212,9420,14.9,2009/08/19(15:00)
2009,08,18,73372,72367,62677,9690,15.5,2009/08/18(15:00)
2009,08,17,73372,72979,61411,11568,18.8,2009/08/17(15:00)
2009,08,16,73372,72002,50351,21651,43,2009/08/16(21:00)
2009,08,15,73372,72002,52995,19007,35.9,2009/08/15(15:00)
2009,08,14,73372,72990,60730,12260,20.2,2009/08/14(15:00)
2009,08,13,73372,72990,60699,12291,20.2,2009/08/13(15:00)
2009,08,12,73372,72990,58564,14426,24.6,2009/08/12(15:00)
2009,08,11,73372,72990,57619,15371,26.7,2009/08/11(15:00)
2009,08,10,73372,72990,60492,12498,20.7,2009/08/10(15:00)
2009,08,09,73372,72990,50348,22642,45,2009/08/09(21:00)
2009,08,08,73372,72990,52192,20798,39.8,2009/08/08(15:00)
2009,08,07,73372,72082,57052,15030,26.3,2009/08/07(15:00)
2009,08,06,73372,72082,57014,15068,26.4,2009/08/06(15:00)
2009,08,05,73372,72969,54900,18069,32.9,2009/08/05(15:00)
2009,08,04,73372,72969,52668,20301,38.5,2009/08/04(15:00)
2009,08,03,73372,72969,49338,23631,47.9,2009/08/03(15:00)
2009,08,02,73372,72969,46763,26206,56,2009/08/02(21:00)
2009,08,01,73372,71652,47347,24305,51.3,2009/08/01(21:00)
2009,07,31,73372,72002,56611,15391,27.2,2009/07/31(15:00)
2009,07,30,73372,72953,58389,14564,24.9,2009/07/30(15:00)
2009,07,29,73372,72953,57923,15030,25.9,2009/07/29(15:00)
2009,07,28,73372,72953,56991,15962,28,2009/07/28(15:00)
2009,07,27,73372,72953,57585,15368,26.7,2009/07/27(15:00)
2009,07,26,73372,71050,46625,24425,52.4,2009/07/26(21:00)
2009,07,25,73372,71050,49542,21508,43.4,2009/07/25(12:00)
2009,07,24,73372,72761,57224,15537,27.2,2009/07/24(15:00)
2009,07,23,73372,72761,58743,14018,23.9,2009/07/23(15:00)
2009,07,22,73372,72761,58226,14535,25,2009/07/22(15:00)
2009,07,21,73372,72761,59592,13169,22.1,2009/07/21(15:00)
2009,07,20,73372,72113,60801,11312,18.6,2009/07/20(15:00)
2009,07,19,73372,71052,49323,21729,44.1,2009/07/19(21:00)
2009,07,18,73372,70402,53370,17032,31.9,2009/07/18(12:00)
2009,07,17,73372,72040,59107,12933,21.9,2009/07/17(15:00)
2009,07,16,73372,71490,59022,12468,21.1,2009/07/16(15:00)
2009,07,15,73372,71385,56502,14883,26.3,2009/07/15(15:00)
2009,07,14,73372,71511,60415,11096,18.4,2009/07/14(15:00)
2009,07,13,73372,71511,58453,13058,22.3,2009/07/13(15:00)
2009,07,12,73372,69924,47301,22623,47.8,2009/07/12(21:00)
2009,07,11,73372,69624,51127,18497,36.2,2009/07/11(12:00)
2009,07,10,73372,71118,58622,12496,21.3,2009/07/10(15:00)
2009,07,09,73372,70525,58746,11779,20.1,2009/07/09(15:00)
2009,07,08,73372,70609,60557,10052,16.6,2009/07/08(15:00)
2009,07,07,73372,70609,57469,13140,22.9,2009/07/07(15:00)
2009,07,06,73372,70566,60089,10477,17.4,2009/07/06(15:00)
2009,07,05,73372,69628,47811,21817,45.6,2009/07/05(21:00)
2009,07,04,73372,69628,50224,19404,38.6,2009/07/04(15:00)
2009,07,03,73372,69123,56383,12740,22.6,2009/07/03(15:00)
2009,07,02,73372,68859,55640,13219,23.8,2009/07/02(15:00)
2009,07,01,73372,69323,56781,12542,22.1,2009/07/01(15:00)
2009,06,30,73697,69656,58911,10745,18.2,2009/06/30(15:00)
2009,06,29,73697,68363,60129,8234,13.7,2009/06/29(15:00)
2009,06,28,73697,68683,48267,20416,42.3,2009/06/28(21:00)
2009,06,27,73697,68158,52277,15881,30.4,2009/06/27(15:00)
2009,06,26,73697,68283,58901,9382,15.9,2009/06/26(15:00)
2009,06,25,73697,68072,58049,10023,17.3,2009/06/25(15:00)
2009,06,24,73697,68172,57728,10444,18.1,2009/06/24(15:00)
2009,06,23,73697,68338,57052,11286,19.8,2009/06/23(15:00)
2009,06,22,73697,67655,55864,11791,21.1,2009/06/22(15:00)
2009,06,21,73697,67802,48082,19720,41,2009/06/21(21:00)
2009,06,20,73697,67151,50328,16823,33.4,2009/06/20(12:00)
2009,06,19,73697,68099,58037,10062,17.3,2009/06/19(15:00)
2009,06,18,73697,68353,56457,11896,21.1,2009/06/18(15:00)
2009,06,17,73697,68012,54583,13429,24.6,2009/06/17(15:00)
2009,06,16,73697,68548,54676,13872,25.4,2009/06/16(15:00)
2009,06,15,73697,68313,53958,14355,26.6,2009/06/15(15:00)
2009,06,14,73697,68052,44854,23198,51.7,2009/06/14(21:00)
2009,06,13,73188,67725,47722,20003,41.9,2009/06/13(12:00)
2009,06,12,73188,68132,53345,14787,27.7,2009/06/12(15:00)
2009,06,11,73188,68046,53343,14703,27.6,2009/06/11(15:00)
2009,06,10,73188,68209,53202,15007,28.2,2009/06/10(15:00)
2009,06,09,73188,68272,52890,15382,29.1,2009/06/09(15:00)
2009,06,08,73148,68169,53265,14904,28,2009/06/08(15:00)
2009,06,07,73148,67340,44363,22977,51.8,2009/06/07(21:00)
2009,06,06,73148,66663,46358,20305,43.8,2009/06/06(15:00)
2009,06,05,73148,67020,53327,13693,25.7,2009/06/05(15:00)
2009,06,04,73148,66364,52843,13521,25.6,2009/06/04(15:00)
2009,06,03,73148,65041,52061,12980,24.9,2009/06/03(15:00)
2009,06,02,73148,67279,53777,13502,25.1,2009/06/02(15:00)
2009,06,01,73148,67479,52570,14909,28.4,2009/06/01(15:00)
2009,05,31,73148,67800,43278,24522,56.7,2009/05/31(21:00)
2009,05,30,73148,67257,45709,21548,47.1,2009/05/30(15:00)
2009,05,29,73148,67036,52423,14613,27.9,2009/05/29(15:00)
2009,05,28,73148,67546,53065,14481,27.3,2009/05/28(15:00)
2009,05,27,73148,67760,53197,14563,27.4,2009/05/27(15:00)
2009,05,26,72629,67145,53033,14112,26.6,2009/05/26(15:00)
2009,05,25,72629,67149,51954,15195,29.2,2009/05/25(15:00)
2009,05,24,72629,66887,43964,22923,52.1,2009/05/24(21:00)
2009,05,23,72629,66748,46280,20468,44.2,2009/05/23(12:00)
2009,05,22,72629,67548,50554,16994,33.6,2009/05/22(15:00)
2009,05,21,72629,67941,51324,16617,32.4,2009/05/21(15:00)
2009,05,20,72629,66056,51936,14120,27.2,2009/05/20(15:00)
2009,05,19,72629,66776,51397,15379,29.9,2009/05/19(15:00)
2009,05,18,72629,66892,50268,16624,33.1,2009/05/18(21:00)
2009,05,17,72629,66351,44125,22226,50.4,2009/05/17(23:00)
2009,05,16,72629,65963,46813,19150,40.9,2009/05/16(11:00)
2009,05,15,72629,66289,51309,14980,29.2,2009/05/15(15:00)
2009,05,14,72629,65764,51338,14426,28.1,2009/05/14(15:00)
2009,05,13,72629,65448,50794,14654,28.8,2009/05/13(11:00)
2009,05,12,72629,64893,51589,13304,25.8,2009/05/12(11:00)
2009,05,11,72629,64658,51536,13122,25.5,2009/05/11(15:00)
2009,05,10,72629,63609,44429,19180,43.2,2009/05/10(21:00)
2009,05,09,72629,64621,46862,17759,37.9,2009/05/09(12:00)
2009,05,08,72629,64521,51616,12905,25,2009/05/08(15:00)
2009,05,07,72629,64131,50939,13192,25.9,2009/05/07(15:00)
2009,05,06,72629,64670,50599,14071,27.8,2009/05/06(15:00)
2009,05,05,72629,64661,45938,18723,40.8,2009/05/05(21:00)
2009,05,04,72629,64661,46825,17836,38.1,2009/05/04(21:00)
2009,05,03,72629,65011,43294,21717,50.2,2009/05/03(23:00)
2009,05,02,72629,64244,44498,19746,44.4,2009/05/02(23:00)
2009,05,01,72629,65034,44772,20262,45.3,2009/05/01(23:00)
2009,04,30,72629,64894,49883,15011,30.1,2009/04/30(11:00)
2009,04,29,72629,64272,50407,13865,27.5,2009/04/29(11:00)
2009,04,28,72629,64272,50488,13784,27.3,2009/04/28(20:00)
2009,04,27,72629,63753,51226,12527,24.5,2009/04/27(20:00)
2009,04,26,72629,62548,46033,16515,35.9,2009/04/26(23:00)
2009,04,25,72629,62296,47911,14385,30,2009/04/25(24:00)
2009,04,24,72629,62390,51051,11339,22.2,2009/04/24(20:00)
2009,04,23,72629,63078,50994,12084,23.7,2009/04/23(20:00)
2009,04,22,72629,62704,51114,11590,22.7,2009/04/22(20:00)
2009,04,21,72629,62805,51821,10984,21.2,2009/04/21(20:00)
2009,04,20,72629,63853,51592,12261,23.8,2009/04/20(15:00)
2009,04,19,72629,63252,44250,19002,42.9,2009/04/19(23:00)
2009,04,18,72629,62344,46026,16318,35.5,2009/04/18(23:00)
2009,04,17,72629,64437,50395,14042,27.9,2009/04/17(11:00)
2009,04,16,72629,64654,52041,12613,24.2,2009/04/16(11:00)
2009,04,15,72629,65150,52067,13083,25.1,2009/04/15(17:00)
2009,04,14,72629,65343,51223,14120,27.6,2009/04/14(20:00)
2009,04,13,72629,65207,51012,14195,27.8,2009/04/13(20:00)
2009,04,12,72629,65105,44195,20910,47.3,2009/04/12(23:00)
2009,04,11,72629,64831,45953,18878,41.1,2009/04/11(23:00)
2009,04,10,72629,66420,50469,15951,31.6,2009/04/10(11:00)
2009,04,09,72629,65475,51342,14133,27.5,2009/04/09(20:00)
2009,04,08,72629,65509,50873,14636,28.8,2009/04/08(20:00)
2009,04,07,72629,65412,51864,13548,26.1,2009/04/07(11:00)
2009,04,06,72629,65456,52194,13262,25.4,2009/04/06(11:00)
2009,04,05,72629,65503,46563,18940,40.7,2009/04/05(23:00)
2009,04,04,72629,65417,48270,17147,35.5,2009/04/04(24:00)
2009,04,03,72629,64944,53216,11728,22,2009/04/03(11:00)
2009,04,02,72629,64944,53453,11491,21.5,2009/04/02(11:00)
2009,04,01,72629,64373,54063,10310,19.1,2009/04/01(11:00)
2009,03,31,72480,65335,53220,12115,22.8,2009/03/31(11:00)
2009,03,30,72480,66211,53448,12763,23.9,2009/03/30(11:00)
2009,03,29,72480,66471,47295,19176,40.5,2009/03/29(23:00)
2009,03,28,72480,66196,49470,16726,33.8,2009/03/28(24:00)
2009,03,27,72480,65978,54917,11061,20.1,2009/03/27(11:00)
2009,03,26,72480,65614,55822,9792,17.5,2009/03/26(11:00)
2009,03,25,72480,65652,55075,10577,19.2,2009/03/25(11:00)
2009,03,24,72480,65744,54655,11089,20.3,2009/03/24(20:00)
2009,03,23,72480,66114,53588,12526,23.4,2009/03/23(20:00)
2009,03,22,72480,65288,46749,18539,39.7,2009/03/22(23:00)
2009,03,21,72480,66388,47092,19296,41,2009/03/21(23:00)
2009,03,20,72480,66911,51983,14928,28.7,2009/03/20(11:00)
2009,03,19,72480,66805,52109,14696,28.2,2009/03/19(20:00)
2009,03,18,72480,66235,52245,13990,26.8,2009/03/18(11:00)
2009,03,17,72480,66471,53677,12794,23.8,2009/03/17(10:00)
2009,03,16,72480,66444,54969,11475,20.9,2009/03/16(11:00)
2009,03,15,72480,65919,49085,16834,34.3,2009/03/15(01:00)
2009,03,14,72480,66535,52205,14330,27.4,2009/03/14(01:00)
2009,03,13,72480,66369,56322,10047,17.8,2009/03/13(11:00)
2009,03,12,72480,66369,55223,11146,20.2,2009/03/12(10:00)
2009,03,11,72480,65993,56506,9487,16.8,2009/03/11(11:00)
2009,03,10,72480,65907,55381,10526,19,2009/03/10(11:00)
2009,03,09,72480,66107,55402,10705,19.3,2009/03/09(11:00)
2009,03,08,72480,65620,48870,16750,34.3,2009/03/08(24:00)
2009,03,07,72480,66720,51479,15241,29.6,2009/03/07(01:00)
2009,03,06,72480,66910,55993,10917,19.5,2009/03/06(11:00)
2009,03,05,72480,66910,56488,10422,18.4,2009/03/05(11:00)
2009,03,04,72480,66911,56892,10019,17.6,2009/03/04(11:00)
2009,03,03,72480,66650,58047,8603,14.8,2009/03/03(11:00)
2009,03,02,72480,67359,55584,11775,21.2,2009/03/02(11:00)
2009,03,01,72480,67821,48955,18866,38.5,2009/03/01(24:00)
2009,02,28,72480,67927,49811,18116,36.4,2009/02/28(24:00)
2009,02,27,72480,68015,55303,12712,23,2009/02/27(11:00)
2009,02,26,72480,68049,55960,12089,21.6,2009/02/26(11:00)
2009,02,25,72480,67768,54976,12792,23.3,2009/02/25(11:00)
2009,02,24,72480,67838,55468,12370,22.3,2009/02/24(11:00)
2009,02,23,72480,67811,56655,11156,19.7,2009/02/23(11:00)
2009,02,22,72480,67607,50234,17373,34.6,2009/02/22(01:00)
2009,02,21,72480,68386,54137,14249,26.3,2009/02/21(01:00)
2009,02,20,72480,68079,58205,9874,17,2009/02/20(11:00)
2009,02,19,72480,68124,59123,9001,15.2,2009/02/19(11:00)
2009,02,18,72480,68410,59360,9050,15.2,2009/02/18(11:00)
2009,02,17,72480,68667,59849,8818,14.7,2009/02/17(11:00)
2009,02,16,72480,68948,59293,9655,16.3,2009/02/16(12:00)
2009,02,15,72480,67848,51010,16838,33,2009/02/15(24:00)
2009,02,14,72480,67336,49896,17440,35,2009/02/14(24:00)
2009,02,13,72480,68292,53827,14465,26.9,2009/02/13(11:00)
2009,02,12,72480,68399,55969,12430,22.2,2009/02/12(10:00)
2009,02,11,72480,67521,56391,11130,19.7,2009/02/11(11:00)
2009,02,10,72480,67440,56957,10483,18.4,2009/02/10(11:00)
2009,02,09,72480,68927,56740,12187,21.5,2009/02/09(11:00)
2009,02,08,72480,67267,49391,17876,36.2,2009/02/08(24:00)
2009,02,07,72480,67635,51088,16547,32.4,2009/02/07(01:00)
2009,02,06,72480,68160,56564,11596,20.5,2009/02/06(11:00)
2009,02,05,72480,68662,56451,12211,21.6,2009/02/05(11:00)
2009,02,04,72480,68662,56833,11829,20.8,2009/02/04(11:00)
2009,02,03,72480,69714,56138,13576,24.2,2009/02/03(11:00)
2009,02,02,72480,69678,56736,12942,22.8,2009/02/02(11:00)
2009,02,01,72480,68705,48964,19741,40.3,2009/02/01(24:00)
2009,01,31,72480,69532,50216,19316,38.5,2009/01/31(24:00)
2009,01,30,72480,69436,56144,13292,23.7,2009/01/30(11:00)
2009,01,29,72480,69396,56164,13232,23.6,2009/01/29(11:00)
2009,01,28,72480,69105,50578,18527,36.6,2009/01/28(24:00)
2009,01,27,72480,67895,46881,21014,44.8,2009/01/27(24:00)
2009,01,26,72480,67345,45285,22060,48.7,2009/01/26(24:00)
2009,01,25,72480,68445,50320,18125,36,2009/01/25(01:00)
2009,01,24,72480,69170,54653,14517,26.6,2009/01/24(01:00)
2009,01,23,72480,69461,59718,9743,16.3,2009/01/23(12:00)
2009,01,22,72480,70302,58567,11735,20,2009/01/22(11:00)
2009,01,21,72480,70262,59758,10504,17.6,2009/01/21(11:00)
2009,01,20,72480,70217,59848,10369,17.3,2009/01/20(11:00)
2009,01,19,72480,70241,59680,10561,17.7,2009/01/19(11:00)
2009,01,18,72480,69321,51885,17436,33.6,2009/01/18(24:00)
2009,01,17,72480,67833,55500,12333,22.2,2009/01/17(01:00)
2009,01,16,72480,69177,61837,7340,11.9,2009/01/16(12:00)
2009,01,15,72480,69404,62529,6875,11,2009/01/15(11:00)
2009,01,14,72480,68258,62245,6013,9.7,2009/01/14(11:00)
2009,01,13,72480,68768,62269,6499,10.4,2009/01/13(11:00)
2009,01,12,72480,68748,62645,6103,9.7,2009/01/12(12:00)
2009,01,11,72480,68178,53691,14487,27,2009/01/11(24:00)
2009,01,10,72480,67483,55131,12352,22.4,2009/01/10(24:00)
2009,01,09,72480,68584,59885,8699,14.5,2009/01/09(11:00)
2009,01,08,72480,68758,59984,8774,14.6,2009/01/08(11:00)
2009,01,07,72480,68527,59337,9190,15.5,2009/01/07(11:00)
2009,01,06,72480,68105,59647,8458,14.2,2009/01/06(11:00)
2009,01,05,72480,68715,58542,10173,17.4,2009/01/05(11:00)
2009,01,04,72480,68190,50030,18160,36.3,2009/01/04(24:00)
2009,01,03,72480,68188,50753,17435,34.4,2009/01/03(24:00)
2009,01,02,72480,68188,51611,16577,32.1,2009/01/02(24:00)
2009,01,01,72480,68242,48935,19307,39.5,2009/01/01(01:00)
2008,12,31,72490,68857,52857,16000,30.3,2008/12/31(11:00)
2008,12,30,72490,68778,54279,14499,26.7,2008/12/30(11:00)
2008,12,29,72490,67908,54390,13518,24.9,2008/12/29(12:00)
2008,12,28,72490,67224,48901,18323,37.5,2008/12/28(24:00)
2008,12,27,71989,67424,50870,16554,32.5,2008/12/27(24:00)
2008,12,26,71989,68461,55113,13348,24.2,2008/12/26(11:00)
2008,12,25,71989,68103,51739,16364,31.6,2008/12/25(24:00)
2008,12,24,71989,68703,56856,11847,20.8,2008/12/24(11:00)
2008,12,23,71989,68757,57634,11123,19.3,2008/12/23(11:00)
2008,12,22,71989,69627,58636,10991,18.7,2008/12/22(18:00)
2008,12,21,71989,68482,50362,18120,36,2008/12/21(24:00)
2008,12,20,71989,67640,50921,16719,32.8,2008/12/20(24:00)
2008,12,19,71989,68219,56927,11292,19.8,2008/12/19(11:00)
2008,12,18,71989,67748,56081,11667,20.8,2008/12/18(11:00)
2008,12,17,71989,68225,55973,12252,21.9,2008/12/17(11:00)
2008,12,16,71989,69021,57017,12004,21.1,2008/12/16(11:00)
2008,12,15,71989,68773,57043,11730,20.6,2008/12/15(11:00)
2008,12,14,71486,67057,50053,17004,34,2008/12/14(24:00)
2008,12,13,71486,66549,51162,15387,30.1,2008/12/13(24:00)
2008,12,12,71486,67980,55350,12630,22.8,2008/12/12(10:00)
2008,12,11,71486,68626,55168,13458,24.4,2008/12/11(18:00)
2008,12,10,71486,68922,54907,14015,25.5,2008/12/10(10:00)
2008,12,09,71486,68629,56160,12469,22.2,2008/12/09(11:00)
2008,12,08,71486,67844,58120,9724,16.7,2008/12/08(11:00)
2008,12,07,71486,66573,51494,15079,29.3,2008/12/07(01:00)
2008,12,06,71486,65863,54297,11566,21.3,2008/12/06(24:00)
2008,12,05,71486,66954,58476,8478,14.5,2008/12/05(18:00)
2008,12,04,71486,66359,55230,11129,20.2,2008/12/04(11:00)
2008,12,03,71486,65515,54992,10523,19.1,2008/12/03(10:00)
2008,12,02,71486,66227,54121,12106,22.4,2008/12/02(11:00)
2008,12,01,71486,66666,54708,11958,21.9,2008/12/01(11:00)
2008,11,30,70532,66510,48331,18179,37.6,2008/11/30(24:00)
2008,11,29,70532,66653,50352,16301,32.4,2008/11/29(24:00)
2008,11,28,70532,65492,54036,11456,21.2,2008/11/28(11:00)
2008,11,27,70532,65471,55778,9693,17.4,2008/11/27(18:00)
2008,11,26,70532,64949,54918,10031,18.3,2008/11/26(11:00)
2008,11,25,70532,65305,55254,10051,18.2,2008/11/25(11:00)
2008,11,24,70532,65382,55358,10024,18.1,2008/11/24(18:00)
2008,11,23,70532,64903,47680,17223,36.1,2008/11/23(24:00)
2008,11,22,70532,65282,50995,14287,28,2008/11/22(01:00)
2008,11,21,70532,66499,55454,11045,19.9,2008/11/21(18:00)
2008,11,20,70532,66372,57695,8677,15,2008/11/20(11:00)
2008,11,19,70532,65095,57592,7503,13,2008/11/19(18:00)
2008,11,18,70532,65095,56535,8560,15.1,2008/11/18(18:00)
2008,11,17,70532,65095,54045,11050,20.4,2008/11/17(19:00)
2008,11,16,70532,64057,45589,18468,40.5,2008/11/16(23:00)
2008,11,15,70532,63653,46685,16968,36.3,2008/11/15(24:00)
2008,11,14,70532,64569,51691,12878,24.9,2008/11/14(19:00)
2008,11,13,70532,64369,52182,12187,23.4,2008/11/13(19:00)
2008,11,12,70532,64560,51808,12752,24.6,2008/11/12(19:00)
2008,11,11,70532,64541,52187,12354,23.7,2008/11/11(19:00)
2008,11,10,70532,64701,52135,12566,24.1,2008/11/10(19:00)
2008,11,09,70532,63000,44727,18273,40.9,2008/11/09(23:00)
2008,11,08,70532,63140,45681,17459,38.2,2008/11/08(24:00)
2008,11,07,70532,64011,51675,12336,23.9,2008/11/07(19:00)
2008,11,06,70532,64035,52041,11994,23,2008/11/06(19:00)
2008,11,05,70532,64049,51727,12322,23.8,2008/11/05(19:00)
2008,11,04,70532,64550,52398,12152,23.2,2008/11/04(19:00)
2008,11,03,70532,64591,51982,12609,24.3,2008/11/03(19:00)
2008,11,02,70532,64329,44411,19918,44.8,2008/11/02(23:00)
2008,11,01,70532,63980,45830,18150,39.6,2008/11/01(23:00)
2008,10,31,70532,65456,51380,14076,27.4,2008/10/31(19:00)
2008,10,30,70532,65001,52125,12876,24.7,2008/10/30(19:00)
2008,10,29,70532,64030,51713,12317,23.8,2008/10/29(19:00)
2008,10,28,70532,63745,52212,11533,22.1,2008/10/28(19:00)
2008,10,27,70532,62599,51928,10671,20.5,2008/10/27(19:00)
2008,10,26,70532,59974,43745,16229,37.1,2008/10/26(23:00)
2008,10,25,70532,60953,45533,15420,33.9,2008/10/25(23:00)
2008,10,24,70532,61929,51403,10526,20.5,2008/10/24(19:00)
2008,10,23,70532,61651,53232,8419,15.8,2008/10/23(19:00)
2008,10,22,70532,62322,52259,10063,19.3,2008/10/22(19:00)
2008,10,21,70532,62360,52943,9417,17.8,2008/10/21(19:00)
2008,10,20,70532,62360,52689,9671,18.4,2008/10/20(19:00)
2008,10,19,70532,61215,43324,17891,41.3,2008/10/19(20:00)
2008,10,18,70532,61985,46470,15515,33.4,2008/10/18(20:00)
2008,10,17,70532,63969,52452,11517,22,2008/10/17(19:00)
2008,10,16,70532,64260,53132,11128,20.9,2008/10/16(19:00)
2008,10,15,70532,64464,52185,12279,23.5,2008/10/15(19:00)
2008,10,14,70532,63510,52584,10926,20.8,2008/10/14(19:00)
2008,10,13,70532,62873,52237,10636,20.4,2008/10/13(19:00)
2008,10,12,70532,60019,43606,16413,37.6,2008/10/12(20:00)
2008,10,11,70532,60412,45675,14737,32.3,2008/10/11(20:00)
2008,10,10,70532,61396,52481,8915,17,2008/10/10(19:00)
2008,10,09,70532,61368,53106,8262,15.6,2008/10/09(19:00)
2008,10,08,70532,61754,52376,9378,17.9,2008/10/08(19:00)
2008,10,07,70532,61885,52803,9082,17.2,2008/10/07(19:00)
2008,10,06,70532,61178,52634,8544,16.2,2008/10/06(19:00)
2008,10,05,70532,59989,43885,16104,36.7,2008/10/05(20:00)
2008,10,04,70532,59937,45818,14119,30.8,2008/10/04(20:00)
2008,10,03,70532,59990,47834,12156,25.4,2008/10/03(20:00)
2008,10,02,70532,60759,51944,8815,17,2008/10/02(20:00)
2008,10,01,70532,60619,51817,8802,17,2008/10/01(20:00)
2008,09,30,70353,60968,51544,9424,18.3,2008/09/30(20:00)
2008,09,29,70353,60674,51196,9478,18.5,2008/09/29(20:00)
2008,09,28,70353,60498,43200,17298,40,2008/09/28(20:00)
2008,09,27,70353,59998,45245,14753,32.6,2008/09/27(12:00)
2008,09,26,70353,62373,50569,11804,23.3,2008/09/26(20:00)
2008,09,25,70353,62196,52810,9386,17.8,2008/09/25(20:00)
2008,09,24,70353,62579,54257,8322,15.3,2008/09/24(15:00)
2008,09,23,70353,62579,55246,7333,13.3,2008/09/23(15:00)
2008,09,22,70353,62601,55430,7171,12.9,2008/09/22(15:00)
2008,09,21,70353,60969,46749,14220,30.4,2008/09/21(20:00)
2008,09,20,70353,61592,50966,10626,20.8,2008/09/20(12:00)
2008,09,19,70353,64072,58509,5563,9.5,2008/09/19(15:00)
2008,09,18,70353,63772,58510,5262,9,2008/09/18(15:00)
2008,09,17,70353,64002,55954,8048,14.4,2008/09/17(15:00)
2008,09,16,70353,63651,48715,14936,30.7,2008/09/16(20:00)
2008,09,15,70353,65285,40474,24811,61.3,2008/09/15(20:00)
2008,09,14,70353,65285,36649,28636,78.1,2008/09/14(21:00)
2008,09,13,70353,65285,40415,24870,61.5,2008/09/13(20:00)
2008,09,12,70353,66831,53880,12951,24,2008/09/12(12:00)
2008,09,11,70353,66798,56543,10255,18.1,2008/09/11(15:00)
2008,09,10,70353,66651,57585,9066,15.7,2008/09/10(15:00)
2008,09,09,70353,66651,58222,8429,14.5,2008/09/09(15:00)
2008,09,08,70353,66255,58219,8036,13.8,2008/09/08(15:00)
2008,09,07,70353,64329,47856,16473,34.4,2008/09/07(20:00)
2008,09,06,70353,65058,50723,14335,28.3,2008/09/06(15:00)
2008,09,05,70353,67087,55678,11409,20.5,2008/09/05(15:00)
2008,09,04,70353,68237,55735,12502,22.4,2008/09/04(15:00)
2008,09,03,70353,69242,56596,12646,22.3,2008/09/03(15:00)
2008,09,02,70353,69259,54917,14342,26.1,2008/09/02(15:00)
2008,09,01,70353,69487,55319,14168,25.6,2008/09/01(15:00)
2008,08,31,70353,69830,46536,23294,50.1,2008/08/31(21:00)
2008,08,30,70353,70185,50791,19394,38.2,2008/08/30(15:00)
2008,08,29,70353,71055,57413,13642,23.8,2008/08/29(15:00)
2008,08,28,70353,71055,56509,14546,25.7,2008/08/28(17:00)
2008,08,27,70353,71609,55526,16083,29,2008/08/27(15:00)
2008,08,26,70353,71989,55634,16355,29.4,2008/08/26(15:00)
2008,08,25,70353,71946,55985,15961,28.5,2008/08/25(15:00)
2008,08,24,70353,71027,45618,25409,55.7,2008/08/24(21:00)
2008,08,23,70353,71682,48272,23410,48.5,2008/08/23(15:00)
2008,08,22,70353,72081,52535,19546,37.2,2008/08/22(12:00)
2008,08,21,70353,72081,54501,17580,32.3,2008/08/21(12:00)
2008,08,20,70353,71669,55810,15859,28.4,2008/08/20(12:00)
2008,08,19,70353,72090,55990,16100,28.8,2008/08/19(12:00)
2008,08,18,70353,71618,56804,14814,26.1,2008/08/18(12:00)
2008,08,17,70353,70632,45791,24841,54.2,2008/08/17(21:00)
2008,08,16,70353,70443,47768,22675,47.5,2008/08/16(12:00)
2008,08,15,70353,70799,53341,17458,32.7,2008/08/15(12:00)
2008,08,14,70353,71896,61297,10599,17.3,2008/08/14(12:00)
2008,08,13,70353,71663,61271,10392,17,2008/08/13(15:00)
2008,08,12,70353,71055,61263,9792,16,2008/08/12(12:00)
2008,08,11,70353,71155,62511,8644,13.8,2008/08/11(15:00)
2008,08,10,70353,69644,52291,17353,33.2,2008/08/10(21:00)
2008,08,09,70353,70310,55237,15073,27.3,2008/08/09(12:00)
2008,08,08,70353,70799,60439,10360,17.1,2008/08/08(17:00)
2008,08,07,70353,71407,58978,12429,21.1,2008/08/07(17:00)
2008,08,06,70353,71407,58157,13250,22.8,2008/08/06(15:00)
2008,08,05,70353,70927,57858,13069,22.6,2008/08/05(15:00)
2008,08,04,70353,71393,55879,15514,27.8,2008/08/04(15:00)
2008,08,03,70353,70569,46960,23609,50.3,2008/08/03(21:00)
2008,08,02,70353,70819,47745,23074,48.3,2008/08/02(15:00)
2008,08,01,70353,70910,53939,16971,31.5,2008/08/01(15:00)
2008,07,31,70353,71026,55427,15599,28.1,2008/07/31(15:00)
2008,07,30,70353,70789,56464,14325,25.4,2008/07/30(15:00)
2008,07,29,70353,69707,59775,9932,16.6,2008/07/29(15:00)
2008,07,28,70353,69995,58289,11706,20.1,2008/07/28(15:00)
2008,07,27,70353,67247,47876,19371,40.5,2008/07/27(21:00)
2008,07,26,70353,67498,49984,17514,35,2008/07/26(12:00)
2008,07,25,70353,68143,56714,11429,20.2,2008/07/25(12:00)
2008,07,24,70353,67655,58152,9503,16.3,2008/07/24(12:00)
2008,07,23,70353,67705,58277,9428,16.2,2008/07/23(12:00)
2008,07,22,70353,68250,57800,10450,18.1,2008/07/22(17:00)
2008,07,21,70353,69313,57926,11387,19.7,2008/07/21(15:00)
2008,07,20,70353,67482,48457,19025,39.3,2008/07/20(21:00)
2008,07,19,70353,67987,53759,14228,26.5,2008/07/19(12:00)
2008,07,18,70353,68514,61548,6966,11.3,2008/07/18(15:00)
2008,07,17,70353,68605,60563,8042,13.3,2008/07/17(15:00)
2008,07,16,70353,68519,60383,8136,13.5,2008/07/16(12:00)
2008,07,15,70353,68519,62794,5725,9.1,2008/07/15(15:00)
2008,07,14,70353,68379,62466,5913,9.5,2008/07/14(15:00)
2008,07,13,70353,66250,49076,17174,35,2008/07/13(21:00)
2008,07,12,70353,64413,52976,11437,21.6,2008/07/12(12:00)
2008,07,11,70353,68146,61017,7129,11.7,2008/07/11(15:00)
2008,07,10,70353,68146,61343,6803,11.1,2008/07/10(15:00)
2008,07,09,70353,68084,62478,5606,9,2008/07/09(15:00)
2008,07,08,70353,66999,62248,4751,7.6,2008/07/08(15:00)
2008,07,07,70353,67260,60234,7026,11.7,2008/07/07(15:00)
2008,07,06,70353,65764,48583,17181,35.4,2008/07/06(21:00)
2008,07,05,70353,65981,51356,14625,28.5,2008/07/05(12:00)
2008,07,04,70353,65629,57398,8231,14.3,2008/07/04(15:00)
2008,07,03,70353,64887,55081,9806,17.8,2008/07/03(15:00)
2008,07,02,70353,66228,54465,11763,21.6,2008/07/02(15:00)
2008,07,01,70353,66228,54770,11458,20.9,2008/07/01(15:00)
2008,06,30,70353,66014,53872,12142,22.5,2008/06/30(15:00)
2008,06,29,70353,65248,44366,20882,47.1,2008/06/29(21:00)
2008,06,28,70353,66222,49013,17209,35.1,2008/06/28(12:00)
2008,06,27,70353,67065,55504,11561,20.8,2008/06/27(15:00)
2008,06,26,70353,66680,54934,11746,21.4,2008/06/26(15:00)
2008,06,25,70353,66463,54365,12098,22.3,2008/06/25(15:00)
2008,06,24,70353,66113,53570,12543,23.4,2008/06/24(15:00)
2008,06,23,70353,65376,53081,12295,23.2,2008/06/23(15:00)
2008,06,22,70353,65310,44551,20759,46.6,2008/06/22(21:00)
2008,06,21,70353,64885,49383,15502,31.4,2008/06/21(12:00)
2008,06,20,70353,66154,54719,11435,20.9,2008/06/20(15:00)
2008,06,19,70353,64919,52780,12139,23,2008/06/19(17:00)
2008,06,18,70353,65069,52571,12498,23.8,2008/06/18(15:00)
2008,06,17,70353,65828,52241,13587,26,2008/06/17(17:00)
2008,06,16,69825,66350,52061,14289,27.4,2008/06/16(17:00)
2008,06,15,69825,64487,43806,20681,47.2,2008/06/15(21:00)
2008,06,14,69825,63414,48565,14849,30.6,2008/06/14(12:00)
2008,06,13,69825,64275,54109,10166,18.8,2008/06/13(15:00)
2008,06,12,69825,63683,54429,9254,17,2008/06/12(17:00)
2008,06,11,69825,62526,53566,8960,16.7,2008/06/11(15:00)
2008,06,10,69825,62299,53545,8754,16.3,2008/06/10(15:00)
2008,06,09,69825,63034,52099,10935,21,2008/06/09(17:00)
2008,06,08,69825,61159,42900,18259,42.6,2008/06/08(21:00)
2008,06,07,69825,61202,44884,16318,36.4,2008/06/07(21:00)
2008,06,06,69825,62436,46629,15807,33.9,2008/06/06(21:00)
2008,06,05,69825,64571,49944,14627,29.3,2008/06/05(12:00)
2008,06,04,69825,64571,50186,14385,28.7,2008/06/04(17:00)
2008,06,03,69825,65053,51159,13894,27.2,2008/06/03(15:00)
2008,06,02,69825,63718,50590,13128,25.9,2008/06/02(17:00)
2008,06,01,69825,62168,43590,18578,42.6,2008/06/01(21:00)
2008,05,31,68888,61568,46173,15395,33.3,2008/05/31(12:00)
2008,05,30,68888,62543,50815,11728,23.1,2008/05/30(15:00)
2008,05,29,68888,62386,52633,9753,18.5,2008/05/29(15:00)
2008,05,28,68888,62765,51264,11501,22.4,2008/05/28(15:00)
2008,05,27,68888,62793,52362,10431,19.9,2008/05/27(15:00)
2008,05,26,68888,63198,50839,12359,24.3,2008/05/26(17:00)
2008,05,25,68888,62163,43954,18209,41.4,2008/05/25(21:00)
2008,05,24,68888,62834,47531,15303,32.2,2008/05/24(12:00)
2008,05,23,68888,62901,51246,11655,22.7,2008/05/23(15:00)
2008,05,22,68888,62367,51070,11297,22.1,2008/05/22(21:00)
2008,05,21,68888,62342,49936,12406,24.8,2008/05/21(15:00)
2008,05,20,68888,61567,49854,11713,23.5,2008/05/20(21:00)
2008,05,19,68888,60791,49408,11383,23,2008/05/19(21:00)
2008,05,18,68888,60640,43986,16654,37.9,2008/05/18(23:00)
2008,05,17,68888,60978,46686,14292,30.6,2008/05/17(12:00)
2008,05,16,68888,62052,49825,12227,24.5,2008/05/16(21:00)
2008,05,15,68888,61959,50304,11655,23.2,2008/05/15(21:00)
2008,05,14,68888,60917,49830,11087,22.2,2008/05/14(21:00)
2008,05,13,68888,60910,50306,10604,21.1,2008/05/13(20:00)
2008,05,12,68888,61438,45738,15700,34.3,2008/05/12(23:00)
2008,05,11,68888,60122,43239,16883,39,2008/05/11(23:00)
2008,05,10,68888,60990,46252,14738,31.9,2008/05/10(12:00)
2008,05,09,68888,61547,49592,11955,24.1,2008/05/09(20:00)
2008,05,08,68888,61228,49958,11270,22.6,2008/05/08(15:00)
2008,05,07,68888,61496,49733,11763,23.7,2008/05/07(20:00)
2008,05,06,68888,61510,49947,11563,23.2,2008/05/06(21:00)
2008,05,05,68888,61426,44025,17401,39.5,2008/05/05(23:00)
2008,05,04,68888,59718,42349,17369,41,2008/05/04(23:00)
2008,05,03,68888,61069,45088,15981,35.4,2008/05/03(15:00)
2008,05,02,68888,61793,48810,12983,26.6,2008/05/02(20:00)
2008,05,01,68888,61793,45929,15864,34.5,2008/05/01(21:00)
2008,04,30,68888,61800,49554,12246,24.7,2008/04/30(15:00)
2008,04,29,68888,61534,50352,11182,22.2,2008/04/29(20:00)
2008,04,28,68888,61652,50053,11599,23.2,2008/04/28(20:00)
2008,04,27,68888,61065,45436,15629,34.4,2008/04/27(23:00)
2008,04,26,68888,62272,47023,15249,32.4,2008/04/26(24:00)
2008,04,25,68888,62466,50045,12421,24.8,2008/04/25(20:00)
2008,04,24,68888,62822,50448,12374,24.5,2008/04/24(20:00)
2008,04,23,68888,62516,50075,12441,24.8,2008/04/23(11:00)
2008,04,22,68888,61855,50544,11311,22.4,2008/04/22(20:00)
2008,04,21,68888,61855,50125,11730,23.4,2008/04/21(20:00)
2008,04,20,68888,63027,43643,19384,44.4,2008/04/20(23:00)
2008,04,19,68888,61430,45571,15859,34.8,2008/04/19(12:00)
2008,04,18,68888,61570,49927,11643,23.3,2008/04/18(20:00)
2008,04,17,68888,61975,50420,11555,22.9,2008/04/17(20:00)
2008,04,16,68888,61755,49796,11959,24,2008/04/16(20:00)
2008,04,15,68888,61751,50308,11443,22.7,2008/04/15(20:00)
2008,04,14,68888,61952,50560,11392,22.5,2008/04/14(20:00)
2008,04,13,68888,61695,45118,16577,36.7,2008/04/13(23:00)
2008,04,12,68888,60953,46686,14267,30.6,2008/04/12(23:00)
2008,04,11,68888,62240,50197,12043,24,2008/04/11(20:00)
2008,04,10,68888,62174,50647,11527,22.8,2008/04/10(20:00)
2008,04,09,68888,62012,49498,12514,25.3,2008/04/09(23:00)
2008,04,08,68888,62545,50088,12457,24.9,2008/04/08(20:00)
2008,04,07,68888,61881,50947,10934,21.5,2008/04/07(20:00)
2008,04,06,68888,61376,44811,16565,37,2008/04/06(23:00)
2008,04,05,68888,61917,46960,14957,31.9,2008/04/05(23:00)
2008,04,04,68888,63504,51128,12376,24.2,2008/04/04(20:00)
2008,04,03,68888,64086,51957,12129,23.3,2008/04/03(20:00)
2008,04,02,68888,63953,52796,11157,21.1,2008/04/02(11:00)
2008,04,01,68888,64354,52288,12066,23.1,2008/04/01(20:00)
2008,03,31,68818,64412,52885,11527,21.8,2008/03/31(20:00)
2008,03,30,68818,63088,47102,15986,33.9,2008/03/30(23:00)
2008,03,29,68818,63088,49355,13733,27.8,2008/03/29(24:00)
2008,03,28,68818,64436,52319,12117,23.2,2008/03/28(20:00)
2008,03,27,68818,64447,53503,10944,20.5,2008/03/27(20:00)
2008,03,26,68818,63615,52591,11024,21,2008/03/26(20:00)
2008,03,25,68818,62762,53713,9049,16.8,2008/03/25(20:00)
2008,03,24,68818,62640,52477,10163,19.4,2008/03/24(20:00)
2008,03,23,68818,63544,46790,16754,35.8,2008/03/23(23:00)
2008,03,22,68818,62563,47792,14771,30.9,2008/03/22(23:00)
2008,03,21,68818,64319,51247,13072,25.5,2008/03/21(20:00)
2008,03,20,68818,63840,52082,11758,22.6,2008/03/20(20:00)
2008,03,19,68818,63448,51986,11462,22,2008/03/19(20:00)
2008,03,18,68818,63717,52375,11342,21.7,2008/03/18(20:00)
2008,03,17,68818,63619,52728,10891,20.7,2008/03/17(20:00)
2008,03,16,68818,63699,46921,16778,35.8,2008/03/16(23:00)
2008,03,15,68818,62935,48826,14109,28.9,2008/03/15(01:00)
2008,03,14,68818,64021,52608,11413,21.7,2008/03/14(20:00)
2008,03,13,68818,63410,53367,10043,18.8,2008/03/13(20:00)
2008,03,12,68818,64280,52902,11378,21.5,2008/03/12(10:00)
2008,03,11,68818,64657,53493,11164,20.9,2008/03/11(10:00)
2008,03,10,68818,64666,54304,10362,19.1,2008/03/10(11:00)
2008,03,09,68818,64654,48347,16307,33.7,2008/03/09(23:00)
2008,03,08,68818,64490,51355,13135,25.6,2008/03/08(01:00)
2008,03,07,68818,65726,55272,10454,18.9,2008/03/07(11:00)
2008,03,06,68818,66253,56686,9567,16.9,2008/03/06(11:00)
2008,03,05,68818,66001,56405,9596,17,2008/03/05(11:00)
2008,03,04,68818,65771,56791,8980,15.8,2008/03/04(11:00)
2008,03,03,68818,65293,55959,9334,16.7,2008/03/03(11:00)
2008,03,02,68818,65598,49323,16275,33,2008/03/02(24:00)
2008,03,01,68818,64676,51472,13204,25.7,2008/03/01(01:00)
2008,02,29,68275,66294,56460,9834,17.4,2008/02/29(11:00)
2008,02,28,68275,66118,57146,8972,15.7,2008/02/28(11:00)
2008,02,27,68275,65811,58316,7495,12.9,2008/02/27(11:00)
2008,02,26,68275,66092,58583,7509,12.8,2008/02/26(12:00)
2008,02,25,68275,66084,58710,7374,12.6,2008/02/25(12:00)
2008,02,24,68275,66657,51214,15443,30.2,2008/02/24(24:00)
2008,02,23,68275,66389,53860,12529,23.3,2008/02/23(24:00)
2008,02,22,68275,67190,56256,10934,19.4,2008/02/22(11:00)
2008,02,21,68275,67190,57611,9579,16.6,2008/02/21(11:00)
2008,02,20,68275,67684,57809,9875,17.1,2008/02/20(11:00)
2008,02,19,68275,67945,59172,8773,14.8,2008/02/19(11:00)
2008,02,18,68275,67501,59464,8037,13.5,2008/02/18(11:00)
2008,02,17,68275,67460,52431,15029,28.7,2008/02/17(01:00)
2008,02,16,68275,68794,55263,13531,24.5,2008/02/16(01:00)
2008,02,15,68275,67701,59398,8303,14,2008/02/15(11:00)
2008,02,14,68275,67153,59689,7464,12.5,2008/02/14(11:00)
2008,02,13,68275,66308,60742,5566,9.2,2008/02/13(11:00)
2008,02,12,68275,65727,60610,5117,8.4,2008/02/12(11:00)
2008,02,11,68275,64893,58683,6210,10.6,2008/02/11(12:00)
2008,02,10,68275,64803,50693,14110,27.8,2008/02/10(24:00)
2008,02,09,68275,64803,49381,15422,31.2,2008/02/09(24:00)
2008,02,08,68275,65140,46181,18959,41.1,2008/02/08(24:00)
2008,02,07,68275,65140,44834,20306,45.3,2008/02/07(01:00)
2008,02,06,68275,65234,50720,14514,28.6,2008/02/06(01:00)
2008,02,05,68275,64868,57215,7653,13.4,2008/02/05(11:00)
2008,02,04,68275,64432,58788,5644,9.6,2008/02/04(11:00)
2008,02,03,68275,65342,53137,12205,23,2008/02/03(24:00)
2008,02,02,68275,64942,55263,9679,17.5,2008/02/02(24:00)
2008,02,01,68275,65944,59181,6763,11.4,2008/02/01(11:00)
2008,01,31,68268,66688,59887,6801,11.4,2008/01/31(11:00)
2008,01,30,68268,66688,59425,7263,12.2,2008/01/30(12:00)
2008,01,29,68268,66688,59673,7015,11.8,2008/01/29(11:00)
2008,01,28,68268,66688,59758,6930,11.6,2008/01/28(12:00)
2008,01,27,68268,65789,52242,13547,25.9,2008/01/27(01:00)
2008,01,26,68268,65489,55430,10059,18.1,2008/01/26(01:00)
2008,01,25,68268,66548,60502,6046,10,2008/01/25(11:00)
2008,01,24,68268,66664,60256,6408,10.6,2008/01/24(11:00)
2008,01,23,68268,66190,58738,7452,12.7,2008/01/23(19:00)
2008,01,22,68268,66176,59449,6727,11.3,2008/01/22(12:00)
2008,01,21,68268,65308,59762,5546,9.3,2008/01/21(12:00)
2008,01,20,68268,64870,52086,12784,24.5,2008/01/20(01:00)
2008,01,19,68268,65391,55656,9735,17.5,2008/01/19(01:00)
2008,01,18,68268,66204,60497,5707,9.4,2008/01/18(11:00)
2008,01,17,68268,65682,60947,4735,7.8,2008/01/17(12:00)
2008,01,16,68268,65626,59938,5688,9.5,2008/01/16(11:00)
2008,01,15,68268,66176,59445,6731,11.3,2008/01/15(19:00)
2008,01,14,68268,65926,58961,6965,11.8,2008/01/14(19:00)
2008,01,13,68268,66376,51660,14716,28.5,2008/01/13(24:00)
2008,01,12,68268,66283,53238,13045,24.5,2008/01/12(24:00)
2008,01,11,68268,65978,58615,7363,12.6,2008/01/11(12:00)
2008,01,10,68268,66374,57368,9006,15.7,2008/01/10(11:00)
2008,01,09,68268,66131,57507,8624,15,2008/01/09(11:00)
2008,01,08,68268,65926,57520,8406,14.6,2008/01/08(11:00)
2008,01,07,68268,65478,57725,7753,13.4,2008/01/07(12:00)
2008,01,06,68268,65213,50859,14354,28.2,2008/01/06(01:00)
2008,01,05,68268,66011,53553,12458,23.3,2008/01/05(01:00)
2008,01,04,68268,66011,58176,7835,13.5,2008/01/04(11:00)
2008,01,03,68268,65811,58416,7395,12.7,2008/01/03(11:00)
2008,01,02,68268,65551,57226,8325,14.5,2008/01/02(19:00)
2008,01,01,68268,64958,50746,14212,28,2008/01/01(01:00)
2007,12,31,68268,66544,52130,14414,27.7,2007/12/31(24:00)
2007,12,30,68251,66544,51955,14589,28.1,2007/12/30(24:00)
2007,12,29,68251,65959,52227,13732,26.3,2007/12/29(24:00)
2007,12,28,68251,65434,55008,10426,19,2007/12/28(11:00)
2007,12,27,68251,65510,55388,10122,18.3,2007/12/27(11:00)
2007,12,26,68251,65631,55084,10547,19.1,2007/12/26(11:00)
2007,12,25,68251,65841,51564,14277,27.7,2007/12/25(24:00)
2007,12,24,68251,66106,55712,10394,18.7,2007/12/24(11:00)
2007,12,23,68251,65321,50655,14666,29,2007/12/23(24:00)
2007,12,22,68251,65627,52512,13115,25,2007/12/22(01:00)
2007,12,21,68251,66380,57435,8945,15.6,2007/12/21(18:00)
2007,12,20,68251,65827,57655,8172,14.2,2007/12/20(19:00)
2007,12,19,68251,65756,54261,11495,21.2,2007/12/19(24:00)
2007,12,18,68251,65999,58004,7995,13.8,2007/12/18(18:00)
2007,12,17,68251,65999,58122,7877,13.6,2007/12/17(19:00)
2007,12,16,68251,65189,51085,14104,27.6,2007/12/16(24:00)
2007,12,15,68251,65464,53078,12386,23.3,2007/12/15(24:00)
2007,12,14,68251,65754,57331,8423,14.7,2007/12/14(19:00)
2007,12,13,68251,65169,58007,7162,12.3,2007/12/13(19:00)
2007,12,12,68251,65049,56912,8137,14.3,2007/12/12(18:00)
2007,12,11,68251,65049,56820,8229,14.5,2007/12/11(19:00)
2007,12,10,68251,64355,57998,6357,11,2007/12/10(18:00)
2007,12,09,68251,63831,50577,13254,26.2,2007/12/09(24:00)
2007,12,08,68251,63465,53024,10441,19.7,2007/12/08(24:00)
2007,12,07,68251,64358,57111,7247,12.7,2007/12/07(18:00)
2007,12,06,68251,64300,58111,6189,10.7,2007/12/06(18:00)
2007,12,05,68251,64299,57850,6449,11.1,2007/12/05(18:00)
2007,12,04,68251,63539,58472,5067,8.7,2007/12/04(19:00)
2007,12,03,68251,64117,57308,6809,11.9,2007/12/03(19:00)
2007,12,02,68251,62089,49294,12795,26,2007/12/02(24:00)
2007,12,01,68251,63018,51225,11793,23,2007/12/01(01:00)
2007,11,30,67196,62794,55687,7107,12.8,2007/11/30(19:00)
2007,11,29,67196,62820,55383,7437,13.4,2007/11/29(19:00)
2007,11,28,67196,62608,55304,7304,13.2,2007/11/28(11:00)
2007,11,27,67196,62536,56595,5941,10.5,2007/11/27(19:00)
2007,11,26,67196,62465,55642,6823,12.3,2007/11/26(19:00)
2007,11,25,67196,62675,48314,14361,29.7,2007/11/25(24:00)
2007,11,24,67196,61440,50556,10884,21.5,2007/11/24(24:00)
2007,11,23,67196,62506,55282,7224,13.1,2007/11/23(18:00)
2007,11,22,67196,62267,56751,5516,9.7,2007/11/22(19:00)
2007,11,21,67196,63838,56200,7638,13.6,2007/11/21(19:00)
2007,11,20,67196,63707,57121,6586,11.5,2007/11/20(19:00)
2007,11,19,67196,64146,57109,7037,12.3,2007/11/19(19:00)
2007,11,18,67196,62880,49039,13841,28.2,2007/11/18(24:00)
2007,11,17,67196,62880,49761,13119,26.4,2007/11/17(24:00)
2007,11,16,67196,62479,53659,8820,16.4,2007/11/16(19:00)
2007,11,15,67196,63072,53330,9742,18.3,2007/11/15(19:00)
2007,11,14,67196,62842,52620,10222,19.4,2007/11/14(19:00)
2007,11,13,67196,63738,53429,10309,19.3,2007/11/13(19:00)
2007,11,12,67196,63489,52675,10814,20.5,2007/11/12(19:00)
2007,11,11,67196,62364,45593,16771,36.8,2007/11/11(23:00)
2007,11,10,67196,63207,47364,15843,33.4,2007/11/10(24:00)
2007,11,09,67196,63948,52023,11925,22.9,2007/11/09(19:00)
2007,11,08,67196,62524,52619,9905,18.8,2007/11/08(19:00)
2007,11,07,67196,63172,51526,11646,22.6,2007/11/07(19:00)
2007,11,06,67196,62503,52394,10109,19.3,2007/11/06(19:00)
2007,11,05,67196,63402,52597,10805,20.5,2007/11/05(19:00)
2007,11,04,67196,62153,45283,16870,37.3,2007/11/04(23:00)
2007,11,03,67196,61293,46914,14379,30.6,2007/11/03(24:00)
2007,11,02,67196,60810,51060,9750,19.1,2007/11/02(19:00)
2007,11,01,67196,61721,51877,9844,19,2007/11/01(19:00)
2007,10,31,67196,60987,51051,9936,19.5,2007/10/31(19:00)
2007,10,30,67196,59905,51878,8027,15.5,2007/10/30(19:00)
2007,10,29,67196,59733,51868,7865,15.2,2007/10/29(19:00)
2007,10,28,67196,61044,43781,17263,39.4,2007/10/28(23:00)
2007,10,27,67196,60426,45478,14948,32.9,2007/10/27(23:00)
2007,10,26,67196,60037,50600,9437,18.7,2007/10/26(19:00)
2007,10,25,67196,60744,51508,9236,17.9,2007/10/25(19:00)
2007,10,24,67196,60255,50696,9559,18.9,2007/10/24(19:00)
2007,10,23,67196,60500,51294,9206,17.9,2007/10/23(19:00)
2007,10,22,67196,60500,50931,9569,18.8,2007/10/22(19:00)
2007,10,21,67196,60647,44221,16426,37.1,2007/10/21(23:00)
2007,10,20,67196,59199,46161,13038,28.2,2007/10/20(23:00)
2007,10,19,67196,59366,49968,9398,18.8,2007/10/19(19:00)
2007,10,18,67196,59366,50465,8901,17.6,2007/10/18(19:00)
2007,10,17,67196,59401,49931,9470,19,2007/10/17(19:00)
2007,10,16,67196,59759,50304,9455,18.8,2007/10/16(19:00)
2007,10,15,67196,59892,49677,10215,20.6,2007/10/15(19:00)
2007,10,14,67196,59203,42218,16985,40.2,2007/10/14(23:00)
2007,10,13,67196,58889,43556,15333,35.2,2007/10/13(11:00)
2007,10,12,67196,59806,49564,10242,20.7,2007/10/12(19:00)
2007,10,11,67196,59806,50044,9762,19.5,2007/10/11(19:00)
2007,10,10,67196,60030,49685,10345,20.8,2007/10/10(20:00)
2007,10,09,67196,59640,50030,9610,19.2,2007/10/09(20:00)
2007,10,08,67196,57582,49993,7589,15.2,2007/10/08(19:00)
2007,10,07,67196,58147,43032,15115,35.1,2007/10/07(20:00)
2007,10,06,67196,57675,45538,12137,26.7,2007/10/06(12:00)
2007,10,05,67196,59376,50563,8813,17.4,2007/10/05(20:00)
2007,10,04,67196,59380,51328,8052,15.7,2007/10/04(20:00)
2007,10,03,67196,58355,47283,11072,23.4,2007/10/03(20:00)
2007,10,02,67196,58685,50772,7913,15.6,2007/10/02(19:00)
2007,10,01,67196,58824,50325,8499,16.9,2007/10/01(20:00)
2007,09,30,67196,58775,42970,15805,36.8,2007/09/30(20:00)
2007,09,29,67196,59035,45188,13847,30.6,2007/09/29(12:00)
2007,09,28,67196,59794,48630,11164,23,2007/09/28(20:00)
2007,09,27,67196,59894,47548,12346,26,2007/09/27(20:00)
2007,09,26,67196,61695,37671,24024,63.8,2007/09/26(20:00)
2007,09,25,67196,60509,34024,26485,77.8,2007/09/25(23:00)
2007,09,24,67196,60552,36266,24286,67,2007/09/24(20:00)
2007,09,23,67196,60552,41191,19361,47,2007/09/23(20:00)
2007,09,22,67196,60470,45931,14539,31.7,2007/09/22(11:00)
2007,09,21,67196,61562,54409,7153,13.1,2007/09/21(15:00)
2007,09,20,67196,61505,57220,4285,7.5,2007/09/20(15:00)
2007,09,19,67196,61281,55475,5806,10.5,2007/09/19(15:00)
2007,09,18,67196,61612,52524,9088,17.3,2007/09/18(20:00)
2007,09,17,67196,61140,53153,7987,15,2007/09/17(20:00)
2007,09,16,67196,60116,43409,16707,38.5,2007/09/16(20:00)
2007,09,15,67196,61318,48419,12899,26.6,2007/09/15(12:00)
2007,09,14,67196,61775,52905,8870,16.8,2007/09/14(15:00)
2007,09,13,67196,62801,54424,8377,15.4,2007/09/13(15:00)
2007,09,12,67196,62264,54931,7333,13.3,2007/09/12(15:00)
2007,09,11,67196,61713,54045,7668,14.2,2007/09/11(15:00)
2007,09,10,67196,62677,53671,9006,16.8,2007/09/10(15:00)
2007,09,09,67196,61766,43371,18395,42.4,2007/09/09(20:00)
2007,09,08,67196,61586,47020,14566,31,2007/09/08(12:00)
2007,09,07,67196,63149,51134,12015,23.5,2007/09/07(20:00)
2007,09,06,67196,64144,50204,13940,27.8,2007/09/06(20:00)
2007,09,05,67196,64768,51041,13727,26.9,2007/09/05(15:00)
2007,09,04,67196,64768,51847,12921,24.9,2007/09/04(20:00)
2007,09,03,67196,64369,52027,12342,23.7,2007/09/03(15:00)
2007,09,02,67196,62759,42545,20214,47.5,2007/09/02(21:00)
2007,09,01,67196,63604,46815,16789,35.9,2007/09/01(12:00)
2007,08,31,67196,66718,52790,13928,26.4,2007/08/31(15:00)
2007,08,30,67196,66718,52947,13771,26,2007/08/30(15:00)
2007,08,29,67196,66718,55558,11160,20.1,2007/08/29(12:00)
2007,08,28,67196,67027,60092,6935,11.5,2007/08/28(15:00)
2007,08,27,67196,66785,61604,5181,8.4,2007/08/27(15:00)
2007,08,26,67196,66046,50541,15505,30.7,2007/08/26(21:00)
2007,08,25,67196,65260,56418,8842,15.7,2007/08/25(15:00)
2007,08,24,67196,66613,61511,5102,8.3,2007/08/24(15:00)
2007,08,23,67196,66613,60529,6084,10.1,2007/08/23(15:00)
2007,08,22,67196,66743,61661,5082,8.2,2007/08/22(15:00)
2007,08,21,67196,66778,62285,4493,7.2,2007/08/21(15:00)
2007,08,20,67196,66006,61545,4461,7.2,2007/08/20(15:00)
2007,08,19,67196,66852,49080,17772,36.2,2007/08/19(21:00)
2007,08,18,67196,66575,54787,11788,21.5,2007/08/18(12:00)
2007,08,17,67196,66975,60603,6372,10.5,2007/08/17(15:00)
2007,08,16,67196,66704,59925,6779,11.3,2007/08/16(15:00)
2007,08,15,67196,66704,52530,14174,27,2007/08/15(21:00)
2007,08,14,67196,66704,57455,9249,16.1,2007/08/14(12:00)
2007,08,13,67196,66704,57454,9250,16.1,2007/08/13(12:00)
2007,08,12,67196,65825,46532,19293,41.5,2007/08/12(21:00)
2007,08,11,67196,64718,52383,12335,23.5,2007/08/11(15:00)
2007,08,10,67196,65756,57432,8324,14.5,2007/08/10(12:00)
2007,08,09,67196,65696,56308,9388,16.7,2007/08/09(12:00)
2007,08,08,67196,66251,52869,13382,25.3,2007/08/08(17:00)
2007,08,07,67196,66929,51701,15228,29.5,2007/08/07(12:00)
2007,08,06,67196,66929,51374,15555,30.3,2007/08/06(17:00)
2007,08,05,66673,66458,44620,21838,48.9,2007/08/05(21:00)
2007,08,04,66673,66398,45846,20552,44.8,2007/08/04(21:00)
2007,08,03,66673,66895,52597,14298,27.2,2007/08/03(14:00)
2007,08,02,66673,66586,52180,14406,27.6,2007/08/02(15:00)
2007,08,01,66673,65741,52123,13618,26.1,2007/08/01(15:00)
2007,07,31,66673,64594,53112,11482,21.6,2007/07/31(15:00)
2007,07,30,66673,64854,53122,11732,22.1,2007/07/30(15:00)
2007,07,29,66673,63538,45338,18200,40.1,2007/07/29(21:00)
2007,07,28,66673,63167,51138,12029,23.5,2007/07/28(12:00)
2007,07,27,66673,65321,57913,7408,12.8,2007/07/27(15:00)
2007,07,26,66673,64731,56929,7802,13.7,2007/07/26(15:00)
2007,07,25,66673,64731,54925,9806,17.9,2007/07/25(15:00)
2007,07,24,66673,64731,53655,11076,20.6,2007/07/24(17:00)
2007,07,23,66673,64731,53359,11372,21.3,2007/07/23(15:00)
2007,07,22,66673,63958,44004,19954,45.3,2007/07/22(21:00)
2007,07,21,66673,63342,47133,16209,34.4,2007/07/21(12:00)
2007,07,20,66673,63769,54439,9330,17.1,2007/07/20(12:00)
2007,07,19,66673,62919,53691,9228,17.2,2007/07/19(12:00)
2007,07,18,66673,63493,55774,7719,13.8,2007/07/18(15:00)
2007,07,17,66673,64250,47556,16694,35.1,2007/07/17(21:00)
2007,07,16,66673,63999,50296,13703,27.2,2007/07/16(15:00)
2007,07,15,66673,64087,44106,19981,45.3,2007/07/15(21:00)
2007,07,14,66673,63808,46809,16999,36.3,2007/07/14(15:00)
2007,07,13,66673,63765,54314,9451,17.4,2007/07/13(15:00)
2007,07,12,66673,63732,54189,9543,17.6,2007/07/12(15:00)
2007,07,11,66673,63765,51130,12635,24.7,2007/07/11(15:00)
2007,07,10,66673,63765,51588,12177,23.6,2007/07/10(15:00)
2007,07,09,66673,63765,53837,9928,18.4,2007/07/09(15:00)
2007,07,08,66673,62975,45148,17827,39.5,2007/07/08(21:00)
2007,07,07,66673,63245,49036,14209,29,2007/07/07(15:00)
2007,07,06,66673,63765,54093,9672,17.9,2007/07/06(15:00)
2007,07,05,66673,62724,53249,9475,17.8,2007/07/05(15:00)
2007,07,04,66673,62692,51555,11137,21.6,2007/07/04(15:00)
2007,07,03,66673,63724,53385,10339,19.4,2007/07/03(15:00)
2007,07,02,66673,63833,51075,12758,25,2007/07/02(15:00)
2007,07,01,66673,62383,42444,19939,47,2007/07/01(21:00)
2007,06,30,66673,60272,48170,12102,25.1,2007/06/30(15:00)
2007,06,29,66673,61812,53249,8563,16.1,2007/06/29(15:00)
2007,06,28,66673,61962,55659,6303,11.3,2007/06/28(15:00)
2007,06,27,66673,61442,55800,5642,10.1,2007/06/27(15:00)
2007,06,26,66673,60875,54551,6324,11.6,2007/06/26(15:00)
2007,06,25,66673,60814,51570,9244,17.9,2007/06/25(17:00)
2007,06,24,66673,60204,43047,17157,39.9,2007/06/24(21:00)
2007,06,23,66673,58034,48084,9950,20.7,2007/06/23(12:00)
2007,06,22,66673,59334,53477,5857,11,2007/06/22(17:00)
2007,06,21,66673,61609,52659,8950,17,2007/06/21(15:00)
2007,06,20,66673,61450,55016,6434,11.7,2007/06/20(15:00)
2007,06,19,66673,61171,54527,6644,12.2,2007/06/19(15:00)
2007,06,18,66673,60442,53508,6934,13,2007/06/18(15:00)
2007,06,17,66673,59836,42762,17074,39.9,2007/06/17(21:00)
2007,06,16,66673,58011,46484,11527,24.8,2007/06/16(12:00)
2007,06,15,66673,59723,50677,9046,17.9,2007/06/15(15:00)
2007,06,14,66673,61347,51176,10171,19.9,2007/06/14(15:00)
2007,06,13,66673,61492,52072,9420,18.1,2007/06/13(15:00)
2007,06,12,66673,61998,52459,9539,18.2,2007/06/12(15:00)
2007,06,11,66673,61610,51890,9720,18.7,2007/06/11(15:00)
2007,06,10,66673,59005,42197,16808,39.8,2007/06/10(21:00)
2007,06,09,66673,58865,44573,14292,32.1,2007/06/09(12:00)
2007,06,08,66673,60113,50084,10029,20,2007/06/08(15:00)
2007,06,07,66673,60682,50041,10641,21.3,2007/06/07(15:00)
2007,06,06,66673,60842,46001,14841,32.3,2007/06/06(21:00)
2007,06,05,66673,61049,49696,11353,22.8,2007/06/05(15:00)
2007,06,04,66673,60517,50104,10413,20.8,2007/06/04(15:00)
2007,06,03,66673,58935,41893,17042,40.7,2007/06/03(21:00)
2007,06,02,66673,58824,44827,13997,31.2,2007/06/02(12:00)
2007,06,01,66673,59405,47696,11709,24.5,2007/06/01(15:00)
2007,05,31,66167,58498,49166,9332,19,2007/05/31(15:00)
2007,05,30,66167,60495,48365,12130,25.1,2007/05/30(16:00)
2007,05,29,66167,60497,48714,11783,24.2,2007/05/29(17:00)
2007,05,28,66167,59460,48731,10729,22,2007/05/28(15:00)
2007,05,27,66167,57805,41604,16201,38.9,2007/05/27(21:00)
2007,05,26,66167,58396,43974,14422,32.8,2007/05/26(12:00)
2007,05,25,66167,58826,47395,11431,24.1,2007/05/25(15:00)
2007,05,24,66167,58507,45392,13115,28.9,2007/05/24(21:00)
2007,05,23,66167,58035,48294,9741,20.2,2007/05/23(15:00)
2007,05,22,66167,58383,48292,10091,20.9,2007/05/22(21:00)
2007,05,21,66167,58295,47770,10525,22,2007/05/21(21:00)
2007,05,20,66167,55298,41560,13738,33.1,2007/05/20(23:00)
2007,05,19,66167,55569,43957,11612,26.4,2007/05/19(12:00)
2007,05,18,66167,56442,47557,8885,18.7,2007/05/18(21:00)
2007,05,17,66167,56288,47865,8423,17.6,2007/05/17(21:00)
2007,05,16,66167,55950,48066,7884,16.4,2007/05/16(17:00)
2007,05,15,66167,55985,47992,7993,16.7,2007/05/15(21:00)
2007,05,14,66167,56785,47849,8936,18.7,2007/05/14(21:00)
2007,05,13,66167,55985,41961,14024,33.4,2007/05/13(23:00)
2007,05,12,66167,55185,44727,10458,23.4,2007/05/12(12:00)
2007,05,11,66167,56456,47697,8759,18.4,2007/05/11(20:00)
2007,05,10,66167,56014,47986,8028,16.7,2007/05/10(21:00)
2007,05,09,66167,57332,48240,9092,18.8,2007/05/09(20:00)
2007,05,08,66167,57014,48343,8671,17.9,2007/05/08(15:00)
2007,05,07,66167,57373,47691,9682,20.3,2007/05/07(21:00)
2007,05,06,66167,57354,41572,15782,38,2007/05/06(23:00)
2007,05,05,66167,58203,42554,15649,36.8,2007/05/05(23:00)
2007,05,04,66167,57417,46928,10489,22.4,2007/05/04(15:00)
2007,05,03,66167,57069,47818,9251,19.3,2007/05/03(20:00)
2007,05,02,66167,57283,46980,10303,21.9,2007/05/02(21:00)
2007,05,01,66167,58327,44748,13579,30.3,2007/05/01(23:00)
2007,04,30,66167,57561,46566,10995,23.6,2007/04/30(20:00)
2007,04,29,66167,56624,41703,14921,35.8,2007/04/29(23:00)
2007,04,28,66167,56654,43641,13013,29.8,2007/04/28(23:00)
2007,04,27,66167,58224,47380,10844,22.9,2007/04/27(20:00)
2007,04,26,66167,57737,47841,9896,20.7,2007/04/26(20:00)
2007,04,25,66167,58330,47768,10562,22.1,2007/04/25(23:00)
2007,04,24,66167,58205,48396,9809,20.3,2007/04/24(20:00)
2007,04,23,66167,57334,47957,9377,19.6,2007/04/23(20:00)
2007,04,22,66167,56513,43033,13480,31.3,2007/04/22(23:00)
2007,04,21,66167,58008,44603,13405,30.1,2007/04/21(23:00)
2007,04,20,66167,59785,48523,11262,23.2,2007/04/20(20:00)
2007,04,19,66167,59528,48635,10893,22.4,2007/04/19(23:00)
2007,04,18,66167,58630,49128,9502,19.3,2007/04/18(23:00)
2007,04,17,66167,58863,49416,9447,19.1,2007/04/17(20:00)
2007,04,16,66167,59777,49220,10557,21.4,2007/04/16(23:00)
2007,04,15,66167,58194,43540,14654,33.7,2007/04/15(23:00)
2007,04,14,66167,57476,45352,12124,26.7,2007/04/14(23:00)
2007,04,13,66167,58424,49213,9211,18.7,2007/04/13(23:00)
2007,04,12,66167,59474,48860,10614,21.7,2007/04/12(20:00)
2007,04,11,66167,59267,48804,10463,21.4,2007/04/11(23:00)
2007,04,10,66167,59199,49231,9968,20.2,2007/04/10(20:00)
2007,04,09,66167,58999,49152,9847,20,2007/04/09(23:00)
2007,04,08,66167,57834,44212,13622,30.8,2007/04/08(23:00)
2007,04,07,66167,57203,45996,11207,24.4,2007/04/07(23:00)
2007,04,06,66167,58963,49193,9770,19.9,2007/04/06(23:00)
2007,04,05,66167,59163,49793,9370,18.8,2007/04/05(20:00)
2007,04,04,66167,59848,50387,9461,18.8,2007/04/04(23:00)
2007,04,03,66167,59573,50750,8823,17.4,2007/04/03(23:00)
2007,04,02,66167,59499,50387,9112,18.1,2007/04/02(23:00)
2007,04,01,66167,58969,44273,14696,33.2,2007/04/01(23:00)
2007,03,31,66167,59261,46890,12371,26.4,2007/03/31(23:00)
2007,03,30,66167,61288,49895,11393,22.8,2007/03/30(23:00)
2007,03,29,66167,61252,50695,10557,20.8,2007/03/29(23:00)
2007,03,28,66167,60085,50364,9721,19.3,2007/03/28(23:00)
2007,03,27,66167,60132,50637,9495,18.8,2007/03/27(23:00)
2007,03,26,66167,59481,50495,8986,17.8,2007/03/26(23:00)
2007,03,25,66167,59765,45010,14755,32.8,2007/03/25(23:00)
2007,03,24,66167,59631,47642,11989,25.2,2007/03/24(23:00)
2007,03,23,66167,59652,50399,9253,18.4,2007/03/23(23:00)
2007,03,22,66167,59378,51596,7782,15.1,2007/03/22(23:00)
2007,03,21,66167,59751,51900,7851,15.1,2007/03/21(23:00)
2007,03,20,66167,59559,52099,7460,14.3,2007/03/20(23:00)
2007,03,19,66037,59200,51972,7228,13.9,2007/03/19(23:00)
2007,03,18,66037,58390,46116,12274,26.6,2007/03/18(23:00)
2007,03,17,66037,58505,48400,10105,20.9,2007/03/17(23:00)
2007,03,16,66037,59105,51638,7467,14.5,2007/03/16(23:00)
2007,03,15,66037,58684,51963,6721,12.9,2007/03/15(23:00)
2007,03,14,66037,59364,52311,7053,13.5,2007/03/14(23:00)
2007,03,13,66037,59828,52735,7093,13.5,2007/03/13(23:00)
2007,03,12,66037,59920,52923,6997,13.2,2007/03/12(23:00)
2007,03,11,66037,59419,47720,11699,24.5,2007/03/11(24:00)
2007,03,10,66037,59346,50077,9269,18.5,2007/03/10(24:00)
2007,03,09,66037,60522,52526,7996,15.2,2007/03/09(23:00)
2007,03,08,66037,60222,53245,6977,13.1,2007/03/08(23:00)
2007,03,07,66037,60383,54041,6342,11.7,2007/03/07(23:00)
2007,03,06,66037,60433,54396,6037,11.1,2007/03/06(24:00)
2007,03,05,66037,60290,53762,6528,12.1,2007/03/05(23:00)
2007,03,04,66037,59581,44937,14644,32.6,2007/03/04(23:00)
2007,03,03,66037,59006,47119,11887,25.2,2007/03/03(23:00)
2007,03,02,66037,59887,50297,9590,19.1,2007/03/02(23:00)
2007,03,01,66037,60006,48345,11661,24.1,2007/03/01(23:00)
2007,02,28,66037,60707,50771,9936,19.6,2007/02/28(23:00)
2007,02,27,65514,61099,51351,9748,19,2007/02/27(23:00)
2007,02,26,65514,61078,51578,9500,18.4,2007/02/26(23:00)
2007,02,25,65514,60395,46255,14140,30.6,2007/02/25(23:00)
2007,02,24,65514,60286,48844,11442,23.4,2007/02/24(23:00)
2007,02,23,65514,61454,52025,9429,18.1,2007/02/23(23:00)
2007,02,22,65514,61413,51563,9850,19.1,2007/02/22(23:00)
2007,02,21,65514,60916,50523,10393,20.6,2007/02/21(23:00)
2007,02,20,65514,60870,46246,14624,31.6,2007/02/20(23:00)
2007,02,19,65514,62072,41617,20455,49.2,2007/02/19(24:00)
2007,02,18,65514,62785,39596,23189,58.6,2007/02/18(01:00)
2007,02,17,65514,62274,45801,16473,36,2007/02/17(01:00)
2007,02,16,65514,62834,51247,11587,22.6,2007/02/16(11:00)
2007,02,15,65514,62571,53771,8800,16.4,2007/02/15(11:00)
2007,02,14,65514,62371,54222,8149,15,2007/02/14(23:00)
2007,02,13,65514,61915,53548,8367,15.6,2007/02/13(19:00)
2007,02,12,65514,61494,53266,8228,15.4,2007/02/12(23:00)
2007,02,11,65514,60316,47620,12696,26.7,2007/02/11(24:00)
2007,02,10,65514,58959,49842,9117,18.3,2007/02/10(24:00)
2007,02,09,65514,61754,52746,9008,17.1,2007/02/09(23:00)
2007,02,08,65514,61374,52466,8908,17,2007/02/08(11:00)
2007,02,07,65514,60532,52411,8121,15.5,2007/02/07(23:00)
2007,02,06,65514,60856,52646,8210,15.6,2007/02/06(23:00)
2007,02,05,65514,62359,53613,8746,16.3,2007/02/05(12:00)
2007,02,04,65514,63770,48825,14945,30.6,2007/02/04(01:00)
2007,02,03,65514,63718,52482,11236,21.4,2007/02/03(01:00)
2007,02,02,65514,63981,55071,8910,16.2,2007/02/02(11:00)
2007,02,01,65514,64281,55402,8879,16,2007/02/01(12:00)
2007,01,31,65514,64116,54626,9490,17.4,2007/01/31(11:00)
2007,01,30,65514,64482,54663,9819,18,2007/01/30(19:00)
2007,01,29,65514,63635,54090,9545,17.6,2007/01/29(11:00)
2007,01,28,65514,63462,48521,14941,30.8,2007/01/28(01:00)
2007,01,27,65514,63462,50696,12766,25.2,2007/01/27(24:00)
2007,01,26,65514,63928,53845,10083,18.7,2007/01/26(11:00)
2007,01,25,65514,63942,53636,10306,19.2,2007/01/25(11:00)
2007,01,24,65514,63942,53453,10489,19.6,2007/01/24(23:00)
2007,01,23,65514,63942,53683,10259,19.1,2007/01/23(11:00)
2007,01,22,65514,63924,53724,10200,19,2007/01/22(19:00)
2007,01,21,65514,62162,48293,13869,28.7,2007/01/21(01:00)
2007,01,20,65514,62162,50630,11532,22.8,2007/01/20(01:00)
2007,01,19,65514,62868,53927,8941,16.6,2007/01/19(11:00)
2007,01,18,65514,63118,54064,9054,16.7,2007/01/18(19:00)
2007,01,17,65514,63418,53672,9746,18.2,2007/01/17(11:00)
2007,01,16,65514,62543,54399,8144,15,2007/01/16(11:00)
2007,01,15,65514,61952,55066,6886,12.5,2007/01/15(11:00)
2007,01,14,65514,62628,49782,12846,25.8,2007/01/14(01:00)
2007,01,13,65514,63912,52184,11728,22.5,2007/01/13(01:00)
2007,01,12,65514,64831,54687,10144,18.5,2007/01/12(19:00)
2007,01,11,65514,64831,54657,10174,18.6,2007/01/11(11:00)
2007,01,10,65514,64831,54312,10519,19.4,2007/01/10(11:00)
2007,01,09,65514,65297,54683,10614,19.4,2007/01/09(11:00)
2007,01,08,65514,65607,54753,10854,19.8,2007/01/08(19:00)
2007,01,07,65514,65491,49141,16350,33.3,2007/01/07(01:00)
2007,01,06,65514,65491,51321,14170,27.6,2007/01/06(24:00)
2007,01,05,65514,65891,52616,13275,25.2,2007/01/05(11:00)
2007,01,04,65514,65909,52790,13119,24.9,2007/01/04(19:00)
2007,01,03,65534,66662,52861,13801,26.1,2007/01/03(11:00)
2007,01,02,65534,65585,51305,14280,27.8,2007/01/02(23:00)
2007,01,01,65534,65144,45479,19665,43.2,2007/01/01(24:00)
2006,12,31,65534,63830,47702,16128,33.8,2006/12/31(01:00)
2006,12,30,65534,63254,51396,11858,23.1,2006/12/30(01:00)
2006,12,29,65534,63840,54003,9837,18.2,2006/12/29(11:00)
2006,12,28,65534,64635,55508,9127,16.4,2006/12/28(18:00)
2006,12,27,65534,64330,53070,11260,21.2,2006/12/27(23:00)
2006,12,26,65534,64330,52176,12154,23.3,2006/12/26(23:00)
2006,12,25,65534,63021,47886,15135,31.6,2006/12/25(23:00)
2006,12,24,65534,62544,47245,15299,32.4,2006/12/24(01:00)
2006,12,23,65534,62454,49919,12535,25.1,2006/12/23(01:00)
2006,12,22,65534,63797,53114,10683,20.1,2006/12/22(23:00)
2006,12,21,65534,65097,53788,11309,21,2006/12/21(23:00)
2006,12,20,65233,65047,53669,11378,21.2,2006/12/20(23:00)
2006,12,19,65233,64487,54805,9682,17.7,2006/12/19(19:00)
2006,12,18,65233,63801,55248,8553,15.5,2006/12/18(19:00)
2006,12,17,65233,63062,48950,14112,28.8,2006/12/17(24:00)
2006,12,16,65233,62096,50458,11638,23.1,2006/12/16(24:00)
2006,12,15,65233,62884,53006,9878,18.6,2006/12/15(18:00)
2006,12,14,65233,63871,53361,10510,19.7,2006/12/14(18:00)
2006,12,13,65233,64144,52796,11348,21.5,2006/12/13(23:00)
2006,12,12,65233,63991,52941,11050,20.9,2006/12/12(23:00)
2006,12,11,65233,64092,54008,10084,18.7,2006/12/11(19:00)
2006,12,10,65233,62333,47885,14448,30.2,2006/12/10(24:00)
2006,12,09,65233,61086,50022,11064,22.1,2006/12/09(24:00)
2006,12,08,65233,60790,53267,7523,14.1,2006/12/08(18:00)
2006,12,07,65233,60697,53798,6899,12.8,2006/12/07(18:00)
2006,12,06,65233,60752,53425,7327,13.7,2006/12/06(23:00)
2006,12,05,65233,60533,53883,6650,12.3,2006/12/05(18:00)
2006,12,04,65233,60402,54505,5897,10.8,2006/12/04(18:00)
2006,12,03,65233,59817,48186,11631,24.1,2006/12/03(24:00)
2006,12,02,65233,59092,50181,8911,17.8,2006/12/02(24:00)
2006,12,01,65233,60334,51910,8424,16.2,2006/12/01(23:00)
2006,11,30,65233,60245,52071,8174,15.7,2006/11/30(23:00)
2006,11,29,65233,60056,51796,8260,15.9,2006/11/29(23:00)
2006,11,28,65233,60175,51062,9113,17.8,2006/11/28(19:00)
2006,11,27,65233,60510,50995,9515,18.7,2006/11/27(18:00)
2006,11,26,65233,60128,44446,15682,35.3,2006/11/26(23:00)
2006,11,25,65233,59849,47032,12817,27.3,2006/11/25(23:00)
2006,11,24,65233,61188,50708,10480,20.7,2006/11/24(23:00)
2006,11,23,65233,61178,51242,9936,19.4,2006/11/23(23:00)
2006,11,22,65233,60560,51111,9449,18.5,2006/11/22(23:00)
2006,11,21,65233,60048,50757,9291,18.3,2006/11/21(19:00)
2006,11,20,65233,59553,50554,8999,17.8,2006/11/20(23:00)
2006,11,19,65233,58870,44580,14290,32.1,2006/11/19(23:00)
2006,11,18,65233,59134,47631,11503,24.2,2006/11/18(23:00)
2006,11,17,65233,60611,51059,9552,18.7,2006/11/17(23:00)
2006,11,16,65233,60537,51631,8906,17.2,2006/11/16(19:00)
2006,11,15,65233,60369,50744,9625,19,2006/11/15(23:00)
2006,11,14,65233,59460,50868,8592,16.9,2006/11/14(19:00)
2006,11,13,65233,59049,49900,9149,18.3,2006/11/13(19:00)
2006,11,12,65233,58888,44066,14822,33.6,2006/11/12(23:00)
2006,11,11,65233,58819,46329,12490,27,2006/11/11(23:00)
2006,11,10,65233,59327,49224,10103,20.5,2006/11/10(23:00)
2006,11,09,65233,59236,49078,10158,20.7,2006/11/09(23:00)
2006,11,08,65233,59351,48980,10371,21.2,2006/11/08(23:00)
2006,11,07,65233,60029,50350,9679,19.2,2006/11/07(19:00)
2006,11,06,65233,59373,49437,9936,20.1,2006/11/06(19:00)
2006,11,05,65233,59449,42362,17087,40.3,2006/11/05(23:00)
2006,11,04,65233,58996,44213,14783,33.4,2006/11/04(23:00)
2006,11,03,65233,60264,47795,12469,26.1,2006/11/03(19:00)
2006,11,02,65233,60315,48139,12176,25.3,2006/11/02(19:00)
2006,11,01,65233,61210,47214,13996,29.6,2006/11/01(19:00)
2006,10,31,65233,61315,47644,13671,28.7,2006/10/31(19:00)
2006,10,30,65233,60965,47464,13501,28.4,2006/10/30(19:00)
2006,10,29,65233,60965,41357,19608,47.4,2006/10/29(23:00)
2006,10,28,65233,60627,43887,16740,38.1,2006/10/28(23:00)
2006,10,27,65233,60910,47333,13577,28.7,2006/10/27(19:00)
2006,10,26,65233,61195,48070,13125,27.3,2006/10/26(19:00)
2006,10,25,65233,60934,47061,13873,29.5,2006/10/25(19:00)
2006,10,24,65233,60758,47274,13484,28.5,2006/10/24(19:00)
2006,10,23,65233,60869,47284,13585,28.7,2006/10/23(19:00)
2006,10,22,65233,59546,41055,18491,45,2006/10/22(23:00)
2006,10,21,65233,58415,43245,15170,35.1,2006/10/21(23:00)
2006,10,20,65233,59393,48083,11310,23.5,2006/10/20(19:00)
2006,10,19,65233,59674,48982,10692,21.8,2006/10/19(19:00)
2006,10,18,65233,59280,48372,10908,22.6,2006/10/18(19:00)
2006,10,17,65233,59240,49033,10207,20.8,2006/10/17(19:00)
2006,10,16,65233,59035,48175,10860,22.5,2006/10/16(19:00)
2006,10,15,65233,58349,40654,17695,43.5,2006/10/15(23:00)
2006,10,14,65233,57971,43272,14699,34,2006/10/14(23:00)
2006,10,13,65233,59333,47578,11755,24.7,2006/10/13(19:00)
2006,10,12,65233,59537,47967,11570,24.1,2006/10/12(19:00)
2006,10,11,65233,59390,47502,11888,25,2006/10/11(19:00)
2006,10,10,65233,59390,48071,11319,23.5,2006/10/10(19:00)
2006,10,09,65233,59537,46515,13022,28,2006/10/09(20:00)
2006,10,08,65233,60141,36954,23187,62.7,2006/10/08(23:00)
2006,10,07,65233,60706,34247,26459,77.3,2006/10/07(23:00)
2006,10,06,65233,60706,31589,29117,92.2,2006/10/06(23:00)
2006,10,05,65233,59282,34557,24725,71.5,2006/10/05(01:00)
2006,10,04,65233,58733,39944,18789,47,2006/10/04(20:00)
2006,10,03,65233,60692,43018,17674,41.1,2006/10/03(20:00)
2006,10,02,65233,59801,46204,13597,29.4,2006/10/02(20:00)
2006,10,01,65233,59859,41396,18463,44.6,2006/10/01(20:00)
2006,09,30,65233,59446,43453,15993,36.8,2006/09/30(12:00)
2006,09,29,64778,59506,47725,11781,24.7,2006/09/29(20:00)
2006,09,28,64778,58040,48773,9267,19,2006/09/28(20:00)
2006,09,27,64778,56869,48401,8468,17.5,2006/09/27(20:00)
2006,09,26,64778,57991,48468,9523,19.6,2006/09/26(20:00)
2006,09,25,64778,59396,48333,11063,22.9,2006/09/25(20:00)
2006,09,24,64778,58950,40233,18717,46.5,2006/09/24(20:00)
2006,09,23,64778,58295,43395,14900,34.3,2006/09/23(12:00)
2006,09,22,64778,59247,48835,10412,21.3,2006/09/22(20:00)
2006,09,21,64778,59445,49008,10437,21.3,2006/09/21(20:00)
2006,09,20,64778,60205,47810,12395,25.9,2006/09/20(20:00)
2006,09,19,64778,60205,48500,11705,24.1,2006/09/19(20:00)
2006,09,18,64778,60270,46980,13290,28.3,2006/09/18(20:00)
2006,09,17,64778,60010,39688,20322,51.2,2006/09/17(23:00)
2006,09,16,64778,59703,43151,16552,38.4,2006/09/16(12:00)
2006,09,15,64778,60735,47600,13135,27.6,2006/09/15(20:00)
2006,09,14,64778,60596,48193,12403,25.7,2006/09/14(20:00)
2006,09,13,64778,60946,47760,13186,27.6,2006/09/13(20:00)
2006,09,12,64778,61046,47826,13220,27.6,2006/09/12(20:00)
2006,09,11,64778,60906,46858,14048,30,2006/09/11(20:00)
2006,09,10,64778,61216,39595,21621,54.6,2006/09/10(23:00)
2006,09,09,64778,61867,44387,17480,39.4,2006/09/09(12:00)
2006,09,08,64778,62532,48718,13814,28.4,2006/09/08(15:00)
2006,09,07,64778,62103,48666,13437,27.6,2006/09/07(17:00)
2006,09,06,64778,61491,47912,13579,28.3,2006/09/06(15:00)
2006,09,05,64778,61642,48863,12779,26.2,2006/09/05(15:00)
2006,09,04,64778,61460,51744,9716,18.8,2006/09/04(15:00)
2006,09,03,64778,59435,42369,17066,40.3,2006/09/03(20:00)
2006,09,02,64778,60430,47149,13281,28.2,2006/09/02(15:00)
2006,09,01,64778,63007,51674,11333,21.9,2006/09/01(15:00)
2006,08,31,64778,64345,52399,11946,22.8,2006/08/31(15:00)
2006,08,30,64778,64725,52076,12649,24.3,2006/08/30(15:00)
2006,08,29,64778,64725,53821,10904,20.3,2006/08/29(15:00)
2006,08,28,64778,64725,54707,10018,18.3,2006/08/28(15:00)
2006,08,27,64778,63877,43742,20135,46,2006/08/27(21:00)
2006,08,26,64778,64368,50038,14330,28.6,2006/08/26(15:00)
2006,08,25,64778,64655,55853,8802,15.8,2006/08/25(15:00)
2006,08,24,64778,64395,56659,7736,13.7,2006/08/24(15:00)
2006,08,23,64778,64966,56230,8736,15.5,2006/08/23(15:00)
2006,08,22,64778,64966,56141,8825,15.7,2006/08/22(15:00)
2006,08,21,64778,65226,55813,9413,16.9,2006/08/21(15:00)
2006,08,20,64778,64043,42970,21073,49,2006/08/20(21:00)
2006,08,19,64778,64093,46107,17986,39,2006/08/19(12:00)
2006,08,18,64778,65183,54061,11122,20.6,2006/08/18(12:00)
2006,08,17,64778,65183,56531,8652,15.3,2006/08/17(12:00)
2006,08,16,64778,65183,58994,6189,10.5,2006/08/16(12:00)
2006,08,15,64778,63890,52087,11803,22.7,2006/08/15(21:00)
2006,08,14,64778,63640,57270,6370,11.1,2006/08/14(15:00)
2006,08,13,64778,62925,47046,15879,33.8,2006/08/13(21:00)
2006,08,12,64778,63640,50995,12645,24.8,2006/08/12(12:00)
2006,08,11,64778,63865,55796,8069,14.5,2006/08/11(12:00)
2006,08,10,64504,62883,57242,5641,9.9,2006/08/10(15:00)
2006,08,09,64504,62529,57063,5466,9.6,2006/08/09(15:00)
2006,08,08,64504,62851,56169,6682,11.9,2006/08/08(15:00)
2006,08,07,64504,63421,54798,8623,15.7,2006/08/07(15:00)
2006,08,06,64504,63119,45705,17414,38.1,2006/08/06(21:00)
2006,08,05,64504,62767,48765,14002,28.7,2006/08/05(12:00)
2006,08,04,64504,63099,53056,10043,18.9,2006/08/04(15:00)
2006,08,03,64504,63119,51775,11344,21.9,2006/08/03(15:00)
2006,08,02,64504,63119,49300,13819,28,2006/08/02(15:00)
2006,08,01,64504,62810,48352,14458,29.9,2006/08/01(15:00)
2006,07,31,64504,62771,48135,14636,30.4,2006/07/31(15:00)
2006,07,30,64504,62283,42988,19295,44.9,2006/07/30(21:00)
2006,07,29,64504,63481,44351,19130,43.1,2006/07/29(12:00)
2006,07,28,64504,62936,48913,14023,28.7,2006/07/28(12:00)
2006,07,27,64504,63193,48852,14341,29.4,2006/07/27(12:00)
2006,07,26,64504,63547,48163,15384,31.9,2006/07/26(12:00)
2006,07,25,64504,63226,49225,14001,28.4,2006/07/25(12:00)
2006,07,24,64504,63278,48130,15148,31.5,2006/07/24(12:00)
2006,07,23,64504,62183,40194,21989,54.7,2006/07/23(21:00)
2006,07,22,64504,62733,44570,18163,40.8,2006/07/22(12:00)
2006,07,21,64504,62863,47547,15316,32.2,2006/07/21(12:00)
2006,07,20,64504,62397,47025,15372,32.7,2006/07/20(12:00)
2006,07,19,64504,61908,46456,15452,33.3,2006/07/19(12:00)
2006,07,18,64504,62958,47245,15713,33.3,2006/07/18(14:00)
2006,07,17,64504,61927,42056,19871,47.2,2006/07/17(21:00)
2006,07,16,64504,61029,40162,20867,52,2006/07/16(21:00)
2006,07,15,64504,60881,48510,12371,25.5,2006/07/15(12:00)
2006,07,14,64504,63100,55263,7837,14.2,2006/07/14(15:00)
2006,07,13,64504,61665,53912,7753,14.4,2006/07/13(15:00)
2006,07,12,64504,61665,52533,9132,17.4,2006/07/12(15:00)
2006,07,11,64504,61068,50439,10629,21.1,2006/07/11(15:00)
2006,07,10,64504,60613,48334,12279,25.4,2006/07/10(12:00)
2006,07,09,64504,59168,42430,16738,39.4,2006/07/09(21:00)
2006,07,08,64504,58698,45277,13421,29.6,2006/07/08(12:00)
2006,07,07,64504,60259,49154,11105,22.6,2006/07/07(15:00)
2006,07,06,64504,58970,47377,11593,24.5,2006/07/06(15:00)
2006,07,05,64504,59290,48662,10628,21.8,2006/07/05(15:00)
2006,07,04,64504,59485,49150,10335,21,2006/07/04(15:00)
2006,07,03,64504,59393,49629,9764,19.7,2006/07/03(17:00)
2006,07,02,64504,58413,40588,17825,43.9,2006/07/02(21:00)
2006,07,01,64504,58158,44307,13851,31.3,2006/07/01(12:00)
2006,06,30,64504,58249,51308,6941,13.5,2006/06/30(15:00)
2006,06,29,64504,58860,51941,6919,13.3,2006/06/29(15:00)
2006,06,28,64504,58391,51310,7081,13.8,2006/06/28(15:00)
2006,06,27,64504,58574,49538,9036,18.2,2006/06/27(15:00)
2006,06,26,64504,57494,48657,8837,18.2,2006/06/26(17:00)
2006,06,25,64504,57794,40399,17395,43.1,2006/06/25(21:00)
2006,06,24,64504,56135,44180,11955,27.1,2006/06/24(12:00)
2006,06,23,64504,58187,50375,7812,15.5,2006/06/23(15:00)
2006,06,22,64504,58473,49337,9136,18.5,2006/06/22(17:00)
2006,06,21,64504,58473,48581,9892,20.4,2006/06/21(15:00)
2006,06,20,64249,57785,49126,8659,17.6,2006/06/20(15:00)
2006,06,19,64249,58081,49076,9005,18.3,2006/06/19(15:00)
2006,06,18,64249,58019,40016,18003,45,2006/06/18(21:00)
2006,06,17,64249,57339,43198,14141,32.7,2006/06/17(12:00)
2006,06,16,64249,59538,47394,12144,25.6,2006/06/16(15:00)
2006,06,15,64249,58697,46680,12017,25.7,2006/06/15(15:00)
2006,06,14,64249,58114,46127,11987,26,2006/06/14(15:00)
2006,06,13,64249,58155,48818,9337,19.1,2006/06/13(16:00)
2006,06,12,64249,57925,47275,10650,22.5,2006/06/12(17:00)
2006,06,11,64249,57962,39437,18525,47,2006/06/11(23:00)
2006,06,10,64249,57275,43850,13425,30.6,2006/06/10(12:00)
2006,06,09,64249,58463,47086,11377,24.2,2006/06/09(15:00)
2006,06,08,64249,57831,46898,10933,23.3,2006/06/08(15:00)
2006,06,07,64249,57031,47739,9292,19.5,2006/06/07(15:00)
2006,06,06,64249,57761,43522,14239,32.7,2006/06/06(21:00)
2006,06,05,64249,57561,46939,10622,22.6,2006/06/05(15:00)
2006,06,04,64249,56259,39332,16927,43,2006/06/04(23:00)
2006,06,03,64249,55759,43710,12049,27.6,2006/06/03(15:00)
2006,06,02,64249,57034,48558,8476,17.5,2006/06/02(15:00)
2006,06,01,64249,57469,46408,11061,23.8,2006/06/01(21:00)
2006,05,31,64249,58264,42487,15777,37.1,2006/05/31(21:00)
2006,05,30,64249,57733,46264,11469,24.8,2006/05/30(15:00)
2006,05,29,64249,58291,45629,12662,27.7,2006/05/29(21:00)
2006,05,28,64249,57095,39532,17563,44.4,2006/05/28(23:00)
2006,05,27,64249,57261,42506,14755,34.7,2006/05/27(23:00)
2006,05,26,64249,56487,45826,10661,23.3,2006/05/26(15:00)
2006,05,25,64249,57051,45836,11215,24.5,2006/05/25(21:00)
2006,05,24,64249,57131,45761,11370,24.8,2006/05/24(21:00)
2006,05,23,64249,56589,45574,11015,24.2,2006/05/23(21:00)
2006,05,22,64249,56294,46070,10224,22.2,2006/05/22(17:00)
2006,05,21,64249,56627,39744,16883,42.5,2006/05/21(23:00)
2006,05,20,64249,56713,42230,14483,34.3,2006/05/20(23:00)
2006,05,19,64249,57110,45587,11523,25.3,2006/05/19(23:00)
2006,05,18,64249,55947,46043,9904,21.5,2006/05/18(21:00)
2006,05,17,64249,58440,45574,12866,28.2,2006/05/17(21:00)
2006,05,16,64249,58136,45839,12297,26.8,2006/05/16(21:00)
2006,05,15,64249,57586,45423,12163,26.8,2006/05/15(21:00)
2006,05,14,63754,57755,40419,17336,42.9,2006/05/14(23:00)
2006,05,13,63754,57499,42908,14591,34,2006/05/13(23:00)
2006,05,12,63754,57958,46146,11812,25.6,2006/05/12(23:00)
2006,05,11,63754,57238,46062,11176,24.3,2006/05/11(21:00)
2006,05,10,63754,56745,45518,11227,24.7,2006/05/10(23:00)
2006,05,09,63754,57126,46201,10925,23.6,2006/05/09(20:00)
2006,05,08,63754,57374,45387,11987,26.4,2006/05/08(23:00)
2006,05,07,63754,57420,39613,17807,45,2006/05/07(23:00)
2006,05,06,63754,57290,41850,15440,36.9,2006/05/06(23:00)
2006,05,05,63754,56605,41910,14695,35.1,2006/05/05(23:00)
2006,05,04,63754,57515,45065,12450,27.6,2006/05/04(23:00)
2006,05,03,63754,57474,45899,11575,25.2,2006/05/03(23:00)
2006,05,02,63754,57124,45519,11605,25.5,2006/05/02(23:00)
2006,05,01,63754,56960,41441,15519,37.4,2006/05/01(23:00)
2006,04,30,63754,57742,40358,17384,43.1,2006/04/30(23:00)
2006,04,29,63754,57392,43444,13948,32.1,2006/04/29(23:00)
2006,04,28,63754,58265,46540,11725,25.2,2006/04/28(23:00)
2006,04,27,63754,57548,46994,10554,22.5,2006/04/27(23:00)
2006,04,26,63754,57638,47142,10496,22.3,2006/04/26(23:00)
2006,04,25,63754,57144,47495,9649,20.3,2006/04/25(23:00)
2006,04,24,63504,56636,47670,8966,18.8,2006/04/24(23:00)
2006,04,23,63504,56096,42621,13475,31.6,2006/04/23(23:00)
2006,04,22,63504,56492,44708,11784,26.4,2006/04/22(23:00)
2006,04,21,63504,58282,47257,11025,23.3,2006/04/21(23:00)
2006,04,20,63504,57108,48484,8624,17.8,2006/04/20(23:00)
2006,04,19,63504,57122,48325,8797,18.2,2006/04/19(23:00)
2006,04,18,63504,56562,46875,9687,20.7,2006/04/18(23:00)
2006,04,17,63504,56804,47487,9317,19.6,2006/04/17(23:00)
2006,04,16,63504,56453,42241,14212,33.6,2006/04/16(23:00)
2006,04,15,63504,56443,44773,11670,26.1,2006/04/15(23:00)
2006,04,14,63504,57192,47119,10073,21.4,2006/04/14(23:00)
2006,04,13,63504,56536,48092,8444,17.6,2006/04/13(23:00)
2006,04,12,63504,55882,47009,8873,18.9,2006/04/12(23:00)
2006,04,11,63504,55642,47262,8380,17.7,2006/04/11(23:00)
2006,04,10,63504,55610,47305,8305,17.6,2006/04/10(23:00)
2006,04,09,63504,54260,41987,12273,29.2,2006/04/09(23:00)
2006,04,08,63504,54583,44628,9955,22.3,2006/04/08(23:00)
2006,04,07,63504,56354,47859,8495,17.8,2006/04/07(23:00)
2006,04,06,63504,55650,48343,7307,15.1,2006/04/06(23:00)
2006,04,05,63504,56065,47677,8388,17.6,2006/04/05(23:00)
2006,04,04,63504,54576,48148,6428,13.4,2006/04/04(23:00)
2006,04,03,63504,56044,47881,8163,17,2006/04/03(23:00)
2006,04,02,63003,55697,43108,12589,29.2,2006/04/02(23:00)
2006,04,01,63003,55897,45353,10544,23.2,2006/04/01(23:00)
2006,03,31,63003,56102,48661,7441,15.3,2006/03/31(23:00)
2006,03,30,63003,56632,49548,7084,14.3,2006/03/30(23:00)
2006,03,29,63003,56882,49664,7218,14.5,2006/03/29(23:00)
2006,03,28,63003,55733,50152,5581,11.1,2006/03/28(23:00)
2006,03,27,63003,55479,48572,6907,14.2,2006/03/27(23:00)
2006,03,26,63003,53509,43207,10302,23.8,2006/03/26(23:00)
2006,03,25,63003,53364,45443,7921,17.4,2006/03/25(23:00)
2006,03,24,63003,55806,48988,6818,13.9,2006/03/24(23:00)
2006,03,23,63003,56833,49229,7604,15.4,2006/03/23(23:00)
2006,03,22,63003,56955,48516,8439,17.4,2006/03/22(23:00)
2006,03,21,63003,57500,48644,8856,18.2,2006/03/21(23:00)
2006,03,20,63003,56800,49531,7269,14.7,2006/03/20(23:00)
2006,03,19,63003,55173,44031,11142,25.3,2006/03/19(23:00)
2006,03,18,63003,55204,46276,8928,19.3,2006/03/18(23:00)
2006,03,17,63003,56568,49169,7399,15,2006/03/17(23:00)
2006,03,16,63003,57573,50652,6921,13.7,2006/03/16(23:00)
2006,03,15,63003,57528,49855,7673,15.4,2006/03/15(23:00)
2006,03,14,63003,57417,51172,6245,12.2,2006/03/14(23:00)
2006,03,13,63003,57467,51722,5745,11.1,2006/03/13(23:00)
2006,03,12,63003,57448,45784,11664,25.5,2006/03/12(24:00)
2006,03,11,63003,57539,46056,11483,24.9,2006/03/11(23:00)
2006,03,10,63003,58623,48410,10213,21.1,2006/03/10(23:00)
2006,03,09,63003,58911,49217,9694,19.7,2006/03/09(23:00)
2006,03,08,63003,58780,49450,9330,18.9,2006/03/08(23:00)
2006,03,07,63003,58852,49436,9416,19,2006/03/07(23:00)
2006,03,06,63003,58065,49665,8400,16.9,2006/03/06(23:00)
2006,03,05,63003,56717,44419,12298,27.7,2006/03/05(01:00)
2006,03,04,63003,58057,47550,10507,22.1,2006/03/04(01:00)
2006,03,03,63003,58903,51123,7780,15.2,2006/03/03(23:00)
2006,03,02,63003,58643,51460,7183,14,2006/03/02(23:00)
2006,03,01,63003,58586,48158,10428,21.7,2006/03/01(23:00)
2006,02,28,63003,59011,50352,8659,17.2,2006/02/28(23:00)
2006,02,27,63003,59136,50942,8194,16.1,2006/02/27(23:00)
2006,02,26,63003,58611,45237,13374,29.6,2006/02/26(24:00)
2006,02,25,63003,59243,46810,12433,26.6,2006/02/25(24:00)
2006,02,24,63003,61126,50030,11096,22.2,2006/02/24(23:00)
2006,02,23,62753,60677,50854,9823,19.3,2006/02/23(23:00)
2006,02,22,62753,60783,51047,9736,19.1,2006/02/22(23:00)
2006,02,21,62753,61575,50252,11323,22.5,2006/02/21(23:00)
2006,02,20,62753,61566,50471,11095,22,2006/02/20(23:00)
2006,02,19,62753,60880,46695,14185,30.4,2006/02/19(01:00)
2006,02,18,62753,61886,50148,11738,23.4,2006/02/18(01:00)
2006,02,17,62753,62257,52206,10051,19.3,2006/02/17(24:00)
2006,02,16,62753,61789,51768,10021,19.4,2006/02/16(24:00)
2006,02,15,62753,61490,50727,10763,21.2,2006/02/15(23:00)
2006,02,14,62753,62622,50606,12016,23.7,2006/02/14(23:00)
2006,02,13,62753,62771,51141,11630,22.7,2006/02/13(11:00)
2006,02,12,62260,62217,47074,15143,32.2,2006/02/12(01:00)
2006,02,11,62260,61942,49660,12282,24.7,2006/02/11(01:00)
2006,02,10,62260,63033,52370,10663,20.4,2006/02/10(12:00)
2006,02,09,62260,63033,53139,9894,18.6,2006/02/09(12:00)
2006,02,08,62260,61873,53397,8476,15.9,2006/02/08(24:00)
2006,02,07,62260,61673,52584,9089,17.3,2006/02/07(24:00)
2006,02,06,62260,61898,52703,9195,17.4,2006/02/06(12:00)
2006,02,05,62260,62048,48937,13111,26.8,2006/02/05(01:00)
2006,02,04,62260,63060,51099,11961,23.4,2006/02/04(01:00)
2006,02,03,62260,62935,53262,9673,18.2,2006/02/03(19:00)
2006,02,02,62260,62094,51455,10639,20.7,2006/02/02(24:00)
2006,02,01,62260,62094,50046,12048,24.1,2006/02/01(24:00)
2006,01,31,62260,62094,44351,17743,40,2006/01/31(24:00)
2006,01,30,62260,62228,40115,22113,55.1,2006/01/30(24:00)
2006,01,29,62260,61768,39237,22531,57.4,2006/01/29(01:00)
2006,01,28,62260,62228,44859,17369,38.7,2006/01/28(01:00)
2006,01,27,62260,62744,49129,13615,27.7,2006/01/27(01:00)
2006,01,26,62260,62510,51551,10959,21.3,2006/01/26(23:00)
2006,01,25,62260,62510,52593,9917,18.9,2006/01/25(24:00)
2006,01,24,62260,62417,52999,9418,17.8,2006/01/24(19:00)
2006,01,23,62260,62510,52671,9839,18.7,2006/01/23(19:00)
2006,01,22,62260,62483,47348,15135,32,2006/01/22(24:00)
2006,01,21,62260,62483,49124,13359,27.2,2006/01/21(24:00)
2006,01,20,62260,62353,51127,11226,22,2006/01/20(24:00)
2006,01,19,62260,62483,51473,11010,21.4,2006/01/19(24:00)
2006,01,18,62260,62224,51500,10724,20.8,2006/01/18(23:00)
2006,01,17,62260,62085,51457,10628,20.7,2006/01/17(19:00)
2006,01,16,62260,62085,51947,10138,19.5,2006/01/16(19:00)
2006,01,15,62260,61821,46009,15812,34.4,2006/01/15(01:00)
2006,01,14,62260,61146,48242,12904,26.7,2006/01/14(01:00)
2006,01,13,62260,61601,51549,10052,19.5,2006/01/13(12:00)
2006,01,12,62260,61876,52493,9383,17.9,2006/01/12(19:00)
2006,01,11,62260,61695,52545,9150,17.4,2006/01/11(11:00)
2006,01,10,62260,60986,52715,8271,15.7,2006/01/10(19:00)
2006,01,09,62260,61786,53277,8509,16,2006/01/09(19:00)
2006,01,08,62260,61118,49286,11832,24,2006/01/08(01:00)
2006,01,07,62260,61749,51620,10129,19.6,2006/01/07(01:00)
2006,01,06,62260,62984,54020,8964,16.6,2006/01/06(12:00)
2006,01,05,62260,63503,54212,9291,17.1,2006/01/05(19:00)
2006,01,04,62260,63679,53740,9939,18.5,2006/01/04(18:00)
2006,01,03,62260,64439,52460,11979,22.8,2006/01/03(19:00)
2006,01,02,62259,64439,50203,14236,28.4,2006/01/02(24:00)
2006,01,01,62259,64414,44836,19578,43.7,2006/01/01(01:00)
2005,12,31,62259,64064,48339,15725,32.5,2005/12/31(01:00)
2005,12,30,62259,64064,50941,13123,25.8,2005/12/30(11:00)
2005,12,29,62259,64065,52570,11495,21.9,2005/12/29(12:00)
2005,12,28,62259,63065,53366,9699,18.2,2005/12/28(12:00)
2005,12,27,62259,63065,53809,9256,17.2,2005/12/27(19:00)
2005,12,26,62259,64065,53935,10130,18.8,2005/12/26(19:00)
2005,12,25,62259,63777,47881,15896,33.2,2005/12/25(01:00)
2005,12,24,62259,62785,50737,12048,23.7,2005/12/24(01:00)
2005,12,23,62259,62480,52786,9694,18.4,2005/12/23(24:00)
2005,12,22,62259,60847,53591,7256,13.5,2005/12/22(19:00)
2005,12,21,62259,60452,54191,6261,11.6,2005/12/21(18:00)
2005,12,20,62241,60409,53737,6672,12.4,2005/12/20(19:00)
2005,12,19,62241,61961,54451,7510,13.8,2005/12/19(19:00)
2005,12,18,62241,60708,49593,11115,22.4,2005/12/18(01:00)
2005,12,17,62241,60773,51395,9378,18.2,2005/12/17(24:00)
2005,12,16,62241,60561,52799,7762,14.7,2005/12/16(24:00)
2005,12,15,62241,60543,53352,7191,13.5,2005/12/15(19:00)
2005,12,14,62241,59114,53330,5784,10.8,2005/12/14(24:00)
2005,12,13,62241,57838,53789,4049,7.5,2005/12/13(19:00)
2005,12,12,62241,57992,53970,4022,7.5,2005/12/12(19:00)
2005,12,11,62241,55840,47081,8759,18.6,2005/12/11(01:00)
2005,12,10,62241,56437,49175,7262,14.8,2005/12/10(01:00)
2005,12,09,62241,57746,51768,5978,11.5,2005/12/09(19:00)
2005,12,08,62241,57634,52468,5166,9.8,2005/12/08(19:00)
2005,12,07,62241,57504,51809,5695,11,2005/12/07(23:00)
2005,12,06,62241,58214,52236,5978,11.4,2005/12/06(19:00)
2005,12,05,62241,58608,52511,6097,11.6,2005/12/05(19:00)
2005,12,04,62241,57684,45864,11820,25.8,2005/12/04(24:00)
2005,12,03,62241,57684,47277,10407,22,2005/12/03(24:00)
2005,12,02,62241,58323,49817,8506,17.1,2005/12/02(23:00)
2005,12,01,62241,57449,49132,8317,16.9,2005/12/01(23:00)
2005,11,30,62241,57508,49589,7919,16,2005/11/30(23:00)
2005,11,29,62241,57324,49402,7922,16,2005/11/29(19:00)
2005,11,28,62241,57260,48733,8527,17.5,2005/11/28(19:00)
2005,11,27,62241,57479,43518,13961,32.1,2005/11/27(23:00)
2005,11,26,62241,57235,45568,11667,25.6,2005/11/26(23:00)
2005,11,25,62241,57739,48663,9076,18.7,2005/11/25(23:00)
2005,11,24,62241,57659,49231,8428,17.1,2005/11/24(23:00)
2005,11,23,62241,58480,48987,9493,19.4,2005/11/23(23:00)
2005,11,22,62241,58595,49982,8613,17.2,2005/11/22(19:00)
2005,11,21,62241,58430,49171,9259,18.8,2005/11/21(23:00)
2005,11,20,62241,58251,43995,14256,32.4,2005/11/20(01:00)
2005,11,19,62241,58706,46249,12457,26.9,2005/11/19(24:00)
2005,11,18,62241,57667,49305,8362,17,2005/11/18(19:00)
2005,11,17,62241,57139,49336,7803,15.8,2005/11/17(19:00)
2005,11,16,62241,57650,48741,8909,18.3,2005/11/16(23:00)
2005,11,15,62241,57905,48663,9242,19,2005/11/15(19:00)
2005,11,14,62241,57538,47732,9806,20.5,2005/11/14(19:00)
2005,11,13,62241,57177,41776,15401,36.9,2005/11/13(23:00)
2005,11,12,62241,56862,44006,12856,29.2,2005/11/12(23:00)
2005,11,11,62241,57872,46163,11709,25.4,2005/11/11(23:00)
2005,11,10,62241,57773,46363,11410,24.6,2005/11/10(19:00)
2005,11,09,62241,57773,46537,11236,24.1,2005/11/09(23:00)
2005,11,08,62241,57223,46854,10369,22.1,2005/11/08(19:00)
2005,11,07,62241,57700,46169,11531,25,2005/11/07(19:00)
2005,11,06,62241,57832,40575,17257,42.5,2005/11/06(23:00)
2005,11,05,62241,57772,42701,15071,35.3,2005/11/05(23:00)
2005,11,04,62241,56963,45801,11162,24.4,2005/11/04(23:00)
2005,11,03,62241,57114,45929,11185,24.4,2005/11/03(23:00)
2005,11,02,62241,57521,46096,11425,24.8,2005/11/02(23:00)
2005,11,01,62241,57525,46085,11440,24.8,2005/11/01(23:00)
2005,10,31,62241,58142,46111,12031,26.1,2005/10/31(23:00)
2005,10,30,62241,57970,41053,16917,41.2,2005/10/30(23:00)
2005,10,29,62241,57898,42952,14946,34.8,2005/10/29(23:00)
2005,10,28,62241,57852,45867,11985,26.1,2005/10/28(23:00)
2005,10,27,62241,57650,46267,11383,24.6,2005/10/27(19:00)
2005,10,26,62241,55404,45782,9622,21,2005/10/26(23:00)
2005,10,25,62241,55638,45859,9779,21.3,2005/10/25(23:00)
2005,10,24,62241,56111,45656,10455,22.9,2005/10/24(23:00)
2005,10,23,62241,56239,40636,15603,38.4,2005/10/23(23:00)
2005,10,22,62241,56753,43191,13562,31.4,2005/10/22(23:00)
2005,10,21,62241,56566,45289,11277,24.9,2005/10/21(23:00)
2005,10,20,62241,56055,45534,10521,23.1,2005/10/20(19:00)
2005,10,19,62241,55956,44963,10993,24.4,2005/10/19(23:00)
2005,10,18,62241,56153,45096,11057,24.5,2005/10/18(19:00)
2005,10,17,62241,55017,44638,10379,23.3,2005/10/17(19:00)
2005,10,16,62241,55187,39174,16013,40.9,2005/10/16(23:00)
2005,10,15,62241,56084,41114,14970,36.4,2005/10/15(23:00)
2005,10,14,62241,56267,44539,11728,26.3,2005/10/14(19:00)
2005,10,13,62241,56665,45395,11270,24.8,2005/10/13(20:00)
2005,10,12,62241,56465,44183,12282,27.8,2005/10/12(20:00)
2005,10,11,62241,57018,45034,11984,26.6,2005/10/11(20:00)
2005,10,10,62241,56273,44716,11557,25.8,2005/10/10(20:00)
2005,10,09,62241,55778,39262,16516,42.1,2005/10/09(23:00)
2005,10,08,62241,55335,41828,13507,32.3,2005/10/08(23:00)
2005,10,07,62241,54719,44575,10144,22.8,2005/10/07(20:00)
2005,10,06,62241,55469,44901,10568,23.5,2005/10/06(20:00)
2005,10,05,62241,56040,44433,11607,26.1,2005/10/05(20:00)
2005,10,04,62241,55929,44466,11463,25.8,2005/10/04(20:00)
2005,10,03,62241,55344,40272,15072,37.4,2005/10/03(23:00)
2005,10,02,62241,55463,37558,17905,47.7,2005/10/02(23:00)
2005,10,01,62241,55798,41891,13907,33.2,2005/10/01(12:00)
2005,09,30,61737,56526,45574,10952,24,2005/09/30(20:00)
2005,09,29,61737,56256,45851,10405,22.7,2005/09/29(20:00)
2005,09,28,61737,56028,45380,10648,23.5,2005/09/28(20:00)
2005,09,27,61737,55934,46012,9922,21.6,2005/09/27(20:00)
2005,09,26,61737,55934,45914,10020,21.8,2005/09/26(20:00)
2005,09,25,61737,54067,38327,15740,41.1,2005/09/25(20:00)
2005,09,24,61737,54301,42017,12284,29.2,2005/09/24(12:00)
2005,09,23,61737,54784,45643,9141,20,2005/09/23(20:00)
2005,09,22,61737,55714,45194,10520,23.3,2005/09/22(20:00)
2005,09,21,61737,56406,43757,12649,28.9,2005/09/21(20:00)
2005,09,20,61737,56734,40105,16629,41.5,2005/09/20(20:00)
2005,09,19,61737,56721,33350,23371,70.1,2005/09/19(23:00)
2005,09,18,61737,56721,31214,25507,81.7,2005/09/18(23:00)
2005,09,17,61737,56198,34880,21318,61.1,2005/09/17(01:00)
2005,09,16,61737,55741,44251,11490,26,2005/09/16(12:00)
2005,09,15,61737,55590,46901,8689,18.5,2005/09/15(20:00)
2005,09,14,61737,55070,47388,7682,16.2,2005/09/14(15:00)
2005,09,13,61737,56029,49152,6877,14,2005/09/13(15:00)
2005,09,12,61737,56469,51162,5307,10.4,2005/09/12(15:00)
2005,09,11,61737,55777,42384,13393,31.6,2005/09/11(20:00)
2005,09,10,61737,55677,45088,10589,23.5,2005/09/10(15:00)
2005,09,09,61737,56476,47653,8823,18.5,2005/09/09(20:00)
2005,09,08,61737,56012,48754,7258,14.9,2005/09/08(17:00)
2005,09,07,61737,56328,47953,8375,17.5,2005/09/07(15:00)
2005,09,06,61737,56091,45112,10979,24.3,2005/09/06(15:00)
2005,09,05,61737,56214,46476,9738,21,2005/09/05(17:00)
2005,09,04,61737,56961,39059,17902,45.8,2005/09/04(21:00)
2005,09,03,61737,56273,45178,11095,24.6,2005/09/03(12:00)
2005,09,02,61737,56612,52052,4560,8.8,2005/09/02(15:00)
2005,09,01,61737,57012,52752,4260,8.1,2005/09/01(15:00)
2005,08,31,61737,59268,49865,9403,18.9,2005/08/31(15:00)
2005,08,30,61737,59268,48676,10592,21.8,2005/08/30(15:00)
2005,08,29,61737,59268,48934,10334,21.1,2005/08/29(17:00)
2005,08,28,61737,59165,40011,19154,47.9,2005/08/28(21:00)
2005,08,27,61737,59165,43196,15969,37,2005/08/27(15:00)
2005,08,26,61737,59608,46025,13583,29.5,2005/08/26(15:00)
2005,08,25,61737,59608,45989,13619,29.6,2005/08/25(15:00)
2005,08,24,61737,60458,45508,14950,32.9,2005/08/24(15:00)
2005,08,23,61737,60848,47458,13390,28.2,2005/08/23(15:00)
2005,08,22,61737,60848,47123,13725,29.1,2005/08/22(15:00)
2005,08,21,61737,59906,39680,20226,51,2005/08/21(21:00)
2005,08,20,61737,60616,43183,17433,40.4,2005/08/20(12:00)
2005,08,19,61737,60848,49558,11290,22.8,2005/08/19(12:00)
2005,08,18,61737,60848,52747,8101,15.4,2005/08/18(12:00)
2005,08,17,61737,60818,54631,6187,11.3,2005/08/17(12:00)
2005,08,16,61737,60818,53601,7217,13.5,2005/08/16(17:00)
2005,08,15,61737,60334,45678,14656,32.1,2005/08/15(21:00)
2005,08,14,61737,60134,43033,17101,39.7,2005/08/14(21:00)
2005,08,13,61737,60576,47490,13086,27.6,2005/08/13(12:00)
2005,08,12,61737,60788,50419,10369,20.6,2005/08/12(12:00)
2005,08,11,61737,61061,49596,11465,23.1,2005/08/11(12:00)
2005,08,10,61737,61170,50228,10942,21.8,2005/08/10(12:00)
2005,08,09,61737,61170,50618,10552,20.8,2005/08/09(12:00)
2005,08,08,61737,59996,49468,10528,21.3,2005/08/08(12:00)
2005,08,07,61737,59903,43036,16867,39.2,2005/08/07(21:00)
2005,08,06,61737,60097,48041,12056,25.1,2005/08/06(12:00)
2005,08,05,61737,60859,51145,9714,19,2005/08/05(15:00)
2005,08,04,61737,60506,49045,11461,23.4,2005/08/04(15:00)
2005,08,03,61737,60506,44195,16311,36.9,2005/08/03(21:00)
2005,08,02,61737,59968,44052,15916,36.1,2005/08/02(15:00)
2005,08,01,61737,59905,43417,16488,38,2005/08/01(21:00)
2005,07,31,61737,58499,41304,17195,41.6,2005/07/31(21:00)
2005,07,30,61737,58699,44218,14481,32.7,2005/07/30(12:00)
2005,07,29,61737,60475,49939,10536,21.1,2005/07/29(15:00)
2005,07,28,61737,59937,49576,10361,20.9,2005/07/28(12:00)
2005,07,27,61737,59283,51903,7380,14.2,2005/07/27(12:00)
2005,07,26,61737,58202,52288,5914,11.3,2005/07/26(12:00)
2005,07,25,61737,58672,52230,6442,12.3,2005/07/25(12:00)
2005,07,24,61737,58041,44052,13989,31.8,2005/07/24(21:00)
2005,07,23,61737,58551,50239,8312,16.5,2005/07/23(15:00)
2005,07,22,61737,58985,53712,5273,9.8,2005/07/22(15:00)
2005,07,21,61737,58775,52725,6050,11.5,2005/07/21(15:00)
2005,07,20,61737,59214,52112,7102,13.6,2005/07/20(17:00)
2005,07,19,61737,58025,50965,7060,13.9,2005/07/19(12:00)
2005,07,18,61737,57980,51624,6356,12.3,2005/07/18(15:00)
2005,07,17,61737,57371,41595,15776,37.9,2005/07/17(21:00)
2005,07,16,61737,57099,46072,11027,23.9,2005/07/16(12:00)
2005,07,15,61737,57132,50200,6932,13.8,2005/07/15(15:00)
2005,07,14,61737,57464,49010,8454,17.2,2005/07/14(15:00)
2005,07,13,61737,57006,47016,9990,21.2,2005/07/13(17:00)
2005,07,12,61737,57006,46354,10652,23,2005/07/12(15:00)
2005,07,11,61737,57595,44711,12884,28.8,2005/07/11(15:00)
2005,07,10,61737,56394,39361,17033,43.3,2005/07/10(21:00)
2005,07,09,61737,56910,42719,14191,33.2,2005/07/09(12:00)
2005,07,08,61737,56826,48156,8670,18,2005/07/08(15:00)
2005,07,07,61737,57232,48010,9222,19.2,2005/07/07(15:00)
2005,07,06,61737,57018,48473,8545,17.6,2005/07/06(15:00)
2005,07,05,61737,55750,46511,9239,19.9,2005/07/05(15:00)
2005,07,04,61737,55416,47063,8353,17.7,2005/07/04(15:00)
2005,07,03,61737,55597,38646,16951,43.9,2005/07/03(21:00)
2005,07,02,61737,55060,43218,11842,27.4,2005/07/02(12:00)
2005,07,01,61737,55310,46720,8590,18.4,2005/07/01(15:00)
2005,06,30,61539,56330,50340,5990,11.9,2005/06/30(15:00)
2005,06,29,60994,57270,48559,8711,17.9,2005/06/29(15:00)
2005,06,28,60994,57112,48314,8798,18.2,2005/06/28(15:00)
2005,06,27,60994,55938,48664,7274,14.9,2005/06/27(15:00)
2005,06,26,60994,55006,40851,14155,34.7,2005/06/26(21:00)
2005,06,25,60994,54173,46104,8069,17.5,2005/06/25(12:00)
2005,06,24,60994,55209,50603,4606,9.1,2005/06/24(15:00)
2005,06,23,60994,55833,49956,5877,11.8,2005/06/23(15:00)
2005,06,22,60994,55833,48917,6916,14.1,2005/06/22(15:00)
2005,06,21,60994,55487,48473,7014,14.5,2005/06/21(15:00)
2005,06,20,60994,56006,47856,8150,17,2005/06/20(15:00)
2005,06,19,60994,56578,38832,17746,45.7,2005/06/19(21:00)
2005,06,18,60994,57939,43198,14741,34.1,2005/06/18(12:00)
2005,06,17,60994,57389,46173,11216,24.3,2005/06/17(15:00)
2005,06,16,60994,57146,45891,11255,24.5,2005/06/16(15:00)
2005,06,15,60994,57266,45572,11694,25.7,2005/06/15(15:00)
2005,06,14,60994,56921,47528,9393,19.8,2005/06/14(15:00)
2005,06,13,60994,56172,46823,9349,20,2005/06/13(15:00)
2005,06,12,60994,56314,38490,17824,46.3,2005/06/12(21:00)
2005,06,11,60994,56235,41569,14666,35.3,2005/06/11(12:00)
2005,06,10,60994,57388,43949,13439,30.6,2005/06/10(12:00)
2005,06,09,60994,56094,46315,9779,21.1,2005/06/09(15:00)
2005,06,08,60994,55685,46046,9639,20.9,2005/06/08(15:00)
2005,06,07,60994,55404,44433,10971,24.7,2005/06/07(21:00)
2005,06,06,60994,56407,40088,16319,40.7,2005/06/06(21:00)
2005,06,05,60994,55580,36940,18640,50.5,2005/06/05(23:00)
2005,06,04,60994,56511,40480,16031,39.6,2005/06/04(12:00)
2005,06,03,60994,57578,43743,13835,31.6,2005/06/03(15:00)
2005,06,02,60994,57578,43468,14110,32.5,2005/06/02(21:00)
2005,06,01,60994,57041,43446,13595,31.3,2005/06/01(15:00)
2005,05,31,60994,57847,44049,13798,31.3,2005/05/31(15:00)
2005,05,30,60994,57604,44006,13598,30.9,2005/05/30(17:00)
2005,05,29,60994,57457,38225,19232,50.3,2005/05/29(21:00)
2005,05,28,60994,57567,40962,16605,40.5,2005/05/28(12:00)
2005,05,27,60994,56870,43871,12999,29.6,2005/05/27(15:00)
2005,05,26,60994,56683,44300,12383,28,2005/05/26(21:00)
2005,05,25,60994,55543,43624,11919,27.3,2005/05/25(21:00)
2005,05,24,60994,55746,43810,11936,27.2,2005/05/24(21:00)
2005,05,23,60994,55844,43763,12081,27.6,2005/05/23(23:00)
2005,05,22,60994,55742,38470,17272,44.9,2005/05/22(23:00)
2005,05,21,60994,56008,40514,15494,38.2,2005/05/21(23:00)
2005,05,20,60994,56066,43119,12947,30,2005/05/20(21:00)
2005,05,19,60994,56508,43532,12976,29.8,2005/05/19(21:00)
2005,05,18,60994,56613,43802,12811,29.2,2005/05/18(23:00)
2005,05,17,60994,56848,43981,12867,29.3,2005/05/17(21:00)
2005,05,16,60994,57180,43583,13597,31.2,2005/05/16(21:00)
2005,05,15,60994,56705,38025,18680,49.1,2005/05/15(23:00)
2005,05,14,60994,57281,40994,16287,39.7,2005/05/14(23:00)
2005,05,13,60994,56660,43561,13099,30.1,2005/05/13(23:00)
2005,05,12,60994,56460,44421,12039,27.1,2005/05/12(23:00)
2005,05,11,60994,56097,44392,11705,26.4,2005/05/11(23:00)
2005,05,10,60994,55790,44107,11683,26.5,2005/05/10(23:00)
2005,05,09,60994,56341,44072,12269,27.8,2005/05/09(23:00)
2005,05,08,60994,56714,38968,17746,45.5,2005/05/08(23:00)
2005,05,07,60994,56568,40987,15581,38,2005/05/07(23:00)
2005,05,06,60994,57597,43561,14036,32.2,2005/05/06(23:00)
2005,05,05,60994,58314,40743,17571,43.1,2005/05/05(23:00)
2005,05,04,60994,58314,43065,15249,35.4,2005/05/04(15:00)
2005,05,03,60994,57528,43554,13974,32.1,2005/05/03(21:00)
2005,05,02,60994,57207,42752,14455,33.8,2005/05/02(21:00)
2005,05,01,60994,57808,36678,21130,57.6,2005/05/01(23:00)
2005,04,30,60994,57969,40655,17314,42.6,2005/04/30(23:00)
2005,04,29,60994,58529,43318,15211,35.1,2005/04/29(21:00)
2005,04,28,60994,59305,43750,15555,35.6,2005/04/28(21:00)
2005,04,27,60994,59130,43615,15515,35.6,2005/04/27(23:00)
2005,04,26,60994,59137,44121,15016,34,2005/04/26(23:00)
2005,04,25,60994,58874,43672,15202,34.8,2005/04/25(23:00)
2005,04,24,60994,57613,39048,18565,47.5,2005/04/24(23:00)
2005,04,23,60994,57699,41787,15912,38.1,2005/04/23(23:00)
2005,04,22,60994,57896,44630,13266,29.7,2005/04/22(23:00)
2005,04,21,59993,57895,44922,12973,28.9,2005/04/21(23:00)
2005,04,20,59993,57355,44675,12680,28.4,2005/04/20(23:00)
2005,04,19,59993,57804,44446,13358,30.1,2005/04/19(23:00)
2005,04,18,59993,57804,44324,13480,30.4,2005/04/18(23:00)
2005,04,17,59993,56452,39316,17136,43.6,2005/04/17(23:00)
2005,04,16,59993,56652,42000,14652,34.9,2005/04/16(23:00)
2005,04,15,59993,57688,44758,12930,28.9,2005/04/15(23:00)
2005,04,14,59993,57395,44921,12474,27.8,2005/04/14(23:00)
2005,04,13,59993,57395,45044,12351,27.4,2005/04/13(23:00)
2005,04,12,59993,57240,45186,12054,26.7,2005/04/12(23:00)
2005,04,11,59993,57423,44792,12631,28.2,2005/04/11(23:00)
2005,04,10,59993,56865,39765,17100,43,2005/04/10(23:00)
2005,04,09,59993,56366,42386,13980,33,2005/04/09(23:00)
2005,04,08,59993,55884,44041,11843,26.9,2005/04/08(23:00)
2005,04,07,59993,56577,44676,11901,26.6,2005/04/07(23:00)
2005,04,06,59993,56579,45272,11307,25,2005/04/06(23:00)
2005,04,05,59993,55682,42672,13010,30.5,2005/04/05(23:00)
2005,04,04,59993,55972,44798,11174,24.9,2005/04/04(23:00)
2005,04,03,59993,55552,40539,15013,37,2005/04/03(23:00)
2005,04,02,59993,55482,41926,13556,32.3,2005/04/02(23:00)
2005,04,01,59993,56297,45123,11174,24.8,2005/04/01(23:00)
2005,03,31,59993,55478,45770,9708,21.2,2005/03/31(23:00)
2005,03,30,59961,55797,46029,9768,21.2,2005/03/30(23:00)
2005,03,29,59961,56592,46546,10046,21.6,2005/03/29(23:00)
2005,03,28,59961,56727,46478,10249,22.1,2005/03/28(23:00)
2005,03,27,59961,56034,41052,14982,36.5,2005/03/27(01:00)
2005,03,26,59961,56192,44215,11977,27.1,2005/03/26(01:00)
2005,03,25,59961,56715,46982,9733,20.7,2005/03/25(23:00)
2005,03,24,59961,56145,47815,8330,17.4,2005/03/24(23:00)
2005,03,23,59961,56708,46565,10143,21.8,2005/03/23(23:00)
2005,03,22,59961,56548,46539,10009,21.5,2005/03/22(23:00)
2005,03,21,59961,56410,46339,10071,21.7,2005/03/21(23:00)
2005,03,20,59961,56390,41783,14607,35,2005/03/20(23:00)
2005,03,19,59961,56291,44303,11988,27.1,2005/03/19(01:00)
2005,03,18,59961,56481,47386,9095,19.2,2005/03/18(23:00)
2005,03,17,59961,55813,47172,8641,18.3,2005/03/17(23:00)
2005,03,16,59961,55658,46775,8883,19,2005/03/16(23:00)
2005,03,15,59961,55753,47816,7937,16.6,2005/03/15(23:00)
2005,03,14,59961,56258,47709,8549,17.9,2005/03/14(23:00)
2005,03,13,59961,54348,44533,9815,22,2005/03/13(01:00)
2005,03,12,59961,54005,46440,7565,16.3,2005/03/12(24:00)
2005,03,11,59961,55886,48374,7512,15.5,2005/03/11(23:00)
2005,03,10,59961,55805,46742,9063,19.4,2005/03/10(23:00)
2005,03,09,59961,55796,46945,8851,18.9,2005/03/09(23:00)
2005,03,08,59961,55796,47363,8433,17.8,2005/03/08(23:00)
2005,03,07,59961,56665,47749,8916,18.7,2005/03/07(23:00)
2005,03,06,59961,56613,44564,12049,27,2005/03/06(01:00)
2005,03,05,59961,57332,46332,11000,23.7,2005/03/05(01:00)
2005,03,04,59961,57738,48698,9040,18.6,2005/03/04(23:00)
2005,03,03,59961,57497,49092,8405,17.1,2005/03/03(23:00)
2005,03,02,59961,57183,48722,8461,17.4,2005/03/02(23:00)
2005,03,01,59961,56739,46189,10550,22.8,2005/03/01(24:00)
2005,02,28,59961,57642,48116,9526,19.8,2005/02/28(23:00)
2005,02,27,59961,57133,45646,11487,25.2,2005/02/27(01:00)
2005,02,26,59961,57305,47397,9908,20.9,2005/02/26(01:00)
2005,02,25,59961,58141,49306,8835,17.9,2005/02/25(24:00)
2005,02,24,59961,57947,49063,8884,18.1,2005/02/24(24:00)
2005,02,23,59961,57738,48821,8917,18.3,2005/02/23(23:00)
2005,02,22,59961,57916,49049,8867,18.1,2005/02/22(24:00)
2005,02,21,59961,57366,49555,7811,15.8,2005/02/21(24:00)
2005,02,20,59961,55589,45393,10196,22.5,2005/02/20(01:00)
2005,02,19,59961,55669,46950,8719,18.6,2005/02/19(24:00)
2005,02,18,59961,55697,48199,7498,15.6,2005/02/18(23:00)
2005,02,17,59961,56769,47802,8967,18.8,2005/02/17(23:00)
2005,02,16,59961,56569,48027,8542,17.8,2005/02/16(23:00)
2005,02,15,59961,56858,47972,8886,18.5,2005/02/15(23:00)
2005,02,14,59961,56298,48186,8112,16.8,2005/02/14(23:00)
2005,02,13,59961,55879,43689,12190,27.9,2005/02/13(24:00)
2005,02,12,59961,56169,44102,12067,27.4,2005/02/12(24:00)
2005,02,11,59961,57685,42630,15055,35.3,2005/02/11(24:00)
2005,02,10,59961,57685,38695,18990,49.1,2005/02/10(24:00)
2005,02,09,59961,57485,36073,21412,59.4,2005/02/09(24:00)
2005,02,08,59961,57250,40465,16785,41.5,2005/02/08(01:00)
2005,02,07,59961,56980,42854,14126,33,2005/02/07(01:00)
2005,02,06,59961,56859,44788,12071,27,2005/02/06(01:00)
2005,02,05,59961,57054,46641,10413,22.3,2005/02/05(24:00)
2005,02,04,59961,56996,48638,8358,17.2,2005/02/04(23:00)
2005,02,03,59961,56987,49315,7672,15.6,2005/02/03(23:00)
2005,02,02,59961,56978,49820,7158,14.4,2005/02/02(24:00)
2005,02,01,59961,55978,49990,5988,12,2005/02/01(24:00)
2005,01,31,59961,56670,49441,7229,14.6,2005/01/31(24:00)
2005,01,30,59961,55808,44556,11252,25.3,2005/01/30(01:00)
2005,01,29,59961,55808,46257,9551,20.6,2005/01/29(24:00)
2005,01,28,59961,55834,47775,8059,16.9,2005/01/28(23:00)
2005,01,27,59961,55034,48056,6978,14.5,2005/01/27(24:00)
2005,01,26,59961,55137,48104,7033,14.6,2005/01/26(23:00)
2005,01,25,59961,54787,48099,6688,13.9,2005/01/25(23:00)
2005,01,24,59961,54787,48192,6595,13.7,2005/01/24(19:00)
2005,01,23,59961,54534,44446,10088,22.7,2005/01/23(01:00)
2005,01,22,59961,54435,47155,7280,15.4,2005/01/22(01:00)
2005,01,21,59961,54876,49023,5853,11.9,2005/01/21(24:00)
2005,01,20,59961,55581,49201,6380,13,2005/01/20(19:00)
2005,01,19,59961,55326,48787,6539,13.4,2005/01/19(24:00)
2005,01,18,59961,55326,48280,7046,14.6,2005/01/18(24:00)
2005,01,17,59961,55938,48285,7653,15.8,2005/01/17(23:00)
2005,01,16,59961,55928,44757,11171,25,2005/01/16(01:00)
2005,01,15,59961,56338,46977,9361,19.9,2005/01/15(01:00)
2005,01,14,59961,57135,48843,8292,17,2005/01/14(24:00)
2005,01,13,59961,56527,49444,7083,14.3,2005/01/13(19:00)
2005,01,12,59961,56817,49337,7480,15.2,2005/01/12(24:00)
2005,01,11,59961,56124,49457,6667,13.5,2005/01/11(19:00)
2005,01,10,59961,54983,49683,5300,10.7,2005/01/10(19:00)
2005,01,09,59961,54344,45202,9142,20.2,2005/01/09(01:00)
2005,01,08,59961,54319,46689,7630,16.3,2005/01/08(24:00)
2005,01,07,59961,54818,48554,6264,12.9,2005/01/07(23:00)
2005,01,06,59961,56376,48187,8189,17,2005/01/06(19:00)
2005,01,05,59961,57429,48249,9180,19,2005/01/05(24:00)
2005,01,04,59961,57429,48671,8758,18,2005/01/04(19:00)
2005,01,03,59961,57331,47151,10180,21.6,2005/01/03(23:00)
2005,01,02,59961,57801,41507,16294,39.3,2005/01/02(24:00)
2005,01,01,59961,58011,42897,15114,35.2,2005/01/01(01:00)
2004,12,31,59961,58308,45574,12734,27.9,2004/12/31(01:00)
2004,12,30,59961,58258,47184,11074,23.5,2004/12/30(00:00)
2004,12,29,59943,58070,47965,10105,21.1,2004/12/29(23:00)
2004,12,28,59943,58532,48369,10163,21,2004/12/28(19:00)
2004,12,27,59943,58532,48087,10445,21.7,2004/12/27(23:00)
2004,12,26,59943,58532,42975,15557,36.2,2004/12/26(00:00)
2004,12,25,59943,58425,45457,12968,28.5,2004/12/25(01:00)
2004,12,24,59943,59225,47201,12024,25.5,2004/12/24(11:00)
2004,12,23,59943,59225,48549,11219,23.1,2004/12/23(23:00)
2004,12,22,59943,58953,48141,10812,22.5,2004/12/22(23:00)
2004,12,21,59943,58353,47834,10519,22,2004/12/21(19:00)
2004,12,20,59943,58531,47857,10674,22.3,2004/12/20(23:00)
2004,12,19,59943,58296,41839,16457,39.3,2004/12/19(01:00)
2004,12,18,59943,57499,43744,13755,31.4,2004/12/18(00:00)
2004,12,17,59943,58144,46315,11829,25.5,2004/12/17(23:00)
2004,12,16,59943,59016,46933,12083,25.7,2004/12/16(23:00)
2004,12,15,59943,59015,46284,12731,27.5,2004/12/15(23:00)
2004,12,14,59943,58319,46713,11606,24.8,2004/12/14(23:00)
2004,12,13,59943,58014,46884,11130,23.7,2004/12/13(23:00)
2004,12,12,59943,57934,41503,16431,39.6,2004/12/12(01:00)
2004,12,11,59943,57934,43551,14383,33,2004/12/11(23:00)
2004,12,10,59943,57704,46369,11335,24.4,2004/12/10(23:00)
2004,12,09,59943,58058,46387,11671,25.2,2004/12/09(23:00)
2004,12,08,59943,58058,46265,11793,25.5,2004/12/08(23:00)
2004,12,07,59943,57948,46401,11547,24.9,2004/12/07(19:00)
2004,12,06,59943,58080,46307,11773,25.4,2004/12/06(19:00)
2004,12,05,59943,57368,41223,16145,39.2,2004/12/05(23:00)
2004,12,04,59943,57370,42651,14719,34.5,2004/12/04(23:00)
2004,12,03,59943,57472,45178,12294,27.2,2004/12/03(23:00)
2004,12,02,59943,57730,45878,11852,25.8,2004/12/02(23:00)
2004,12,01,59943,57730,46150,11580,25.1,2004/12/01(23:00)
2004,11,30,59943,57780,46241,11539,25,2004/11/30(23:00)
2004,11,29,59129,58849,45910,12539,27.3,2004/11/29(23:00)
2004,11,28,59129,57741,40717,17024,41.8,2004/11/28(23:00)
2004,11,27,59129,57703,42870,14833,34.6,2004/11/27(01:00)
2004,11,26,59129,58063,45776,12287,26.8,2004/11/26(23:00)
2004,11,25,59129,57792,45420,12372,27.2,2004/11/25(23:00)
2004,11,24,59129,56984,45550,11434,25.1,2004/11/24(23:00)
2004,11,23,59129,56784,45794,10990,24,2004/11/23(23:00)
2004,11,22,59129,56784,45445,11339,25,2004/11/22(23:00)
2004,11,21,59129,55934,40224,15710,39.1,2004/11/21(23:00)
2004,11,20,59129,55848,42809,13039,30.5,2004/11/20(23:00)
2004,11,19,59129,54789,45062,9727,21.6,2004/11/19(23:00)
2004,11,18,59129,54789,45183,9606,21.3,2004/11/18(23:00)
2004,11,17,59129,53865,45340,8525,18.8,2004/11/17(23:00)
2004,11,16,59129,53865,45322,8543,18.8,2004/11/16(19:00)
2004,11,15,59129,53817,45572,8245,18.1,2004/11/15(19:00)
2004,11,14,59129,53456,39781,13675,34.4,2004/11/14(01:00)
2004,11,13,59129,53717,42256,11461,27.1,2004/11/13(23:00)
2004,11,12,59129,53097,44745,8352,18.7,2004/11/12(23:00)
2004,11,11,59129,53114,44330,8784,19.8,2004/11/11(23:00)
2004,11,10,59129,52840,44065,8775,19.9,2004/11/10(23:00)
2004,11,09,59129,53021,44231,8790,19.9,2004/11/09(17:00)
2004,11,08,59129,53663,44661,9002,20.2,2004/11/08(19:00)
2004,11,07,59129,53326,38822,14504,37.4,2004/11/07(23:00)
2004,11,06,59129,53444,41418,12026,29,2004/11/06(23:00)
2004,11,05,59129,52913,44047,8866,20.1,2004/11/05(19:00)
2004,11,04,59129,53313,44401,8912,20.1,2004/11/04(19:00)
2004,11,03,59129,53290,44226,9064,20.5,2004/11/03(23:00)
2004,11,02,59129,52432,44409,8023,18.1,2004/11/02(19:00)
2004,11,01,59129,52432,43655,8777,20.1,2004/11/01(19:00)
2004,10,31,59129,51698,38285,13413,35,2004/10/31(23:00)
2004,10,30,59129,51647,40659,10988,27,2004/10/30(23:00)
2004,10,29,59129,51913,43129,8784,20.4,2004/10/29(19:00)
2004,10,28,59129,51858,43869,7989,18.2,2004/10/28(19:00)
2004,10,27,59129,51534,43601,7933,18.2,2004/10/27(23:00)
2004,10,26,59129,51556,44272,7284,16.5,2004/10/26(19:00)
2004,10,25,59129,51987,43891,8096,18.4,2004/10/25(19:00)
2004,10,24,59129,51834,38251,13583,35.5,2004/10/24(23:00)
2004,10,23,59129,51834,40868,10966,26.8,2004/10/23(23:00)
2004,10,22,59129,52077,43106,8971,20.8,2004/10/22(23:00)
2004,10,21,59129,51919,43757,8162,18.7,2004/10/21(19:00)
2004,10,20,59129,51799,43037,8762,20.4,2004/10/20(23:00)
2004,10,19,59129,50815,43532,7283,16.7,2004/10/19(19:00)
2004,10,18,59129,51269,43027,8242,19.2,2004/10/18(19:00)
2004,10,17,59129,51269,37717,13025,34.5,2004/10/17(23:00)
2004,10,16,59129,51225,40224,11001,27.3,2004/10/16(23:00)
2004,10,15,59129,51869,42771,9098,21.3,2004/10/15(23:00)
2004,10,14,59129,50758,43089,7669,17.8,2004/10/14(23:00)
2004,10,13,59129,50837,42573,8264,19.4,2004/10/13(23:00)
2004,10,12,59129,50815,42769,8046,18.8,2004/10/12(19:00)
2004,10,11,59129,50862,43191,7671,17.8,2004/10/11(20:00)
2004,10,10,59129,50444,36952,13492,36.5,2004/10/10(23:00)
2004,10,09,59129,50319,39498,10821,27.4,2004/10/09(23:00)
2004,10,08,59129,50617,43098,7519,17.4,2004/10/08(20:00)
2004,10,07,59129,49988,43244,6744,15.6,2004/10/07(19:00)
2004,10,06,59129,49988,42689,7301,17.1,2004/10/06(20:00)
2004,10,05,59129,50566,43035,7531,17.5,2004/10/05(20:00)
2004,10,04,59129,50182,42683,7499,17.6,2004/10/04(20:00)
2004,10,03,59129,50687,37159,13528,36.4,2004/10/03(23:00)
2004,10,02,59129,50744,39098,11646,29.8,2004/10/02(23:00)
2004,10,01,59129,51843,41007,10836,26.4,2004/10/01(20:00)
2004,09,30,59129,53953,37811,16142,42.7,2004/09/30(20:00)
2004,09,29,59129,54418,31357,23061,73.5,2004/09/29(23:00)
2004,09,28,59129,52870,28783,24087,83.7,2004/09/28(23:00)
2004,09,27,59129,52870,30354,22516,74.2,2004/09/27(01:00)
2004,09,26,59129,52870,34265,18605,54.3,2004/09/26(23:00)
2004,09,25,59129,52915,37974,14941,39.3,2004/09/25(12:00)
2004,09,24,59129,53688,42841,10847,25.3,2004/09/24(20:00)
2004,09,23,59129,53437,43671,9766,22.4,2004/09/23(20:00)
2004,09,22,59129,53605,43231,10374,24,2004/09/22(20:00)
2004,09,21,59129,53852,43588,10264,23.5,2004/09/21(20:00)
2004,09,20,59129,53041,43493,9548,22,2004/09/20(20:00)
2004,09,19,59129,52839,37165,15674,42.2,2004/09/19(20:00)
2004,09,18,59129,52943,42709,10234,24,2004/09/18(12:00)
2004,09,17,59129,53257,46566,6691,14.4,2004/09/17(15:00)
2004,09,16,59129,53597,46177,7420,16.1,2004/09/16(20:00)
2004,09,15,59129,53107,45571,7536,16.5,2004/09/15(20:00)
2004,09,14,59129,52686,45342,7344,16.2,2004/09/14(20:00)
2004,09,13,59129,52297,44751,7546,16.9,2004/09/13(20:00)
2004,09,12,59129,52080,37337,14743,39.5,2004/09/12(21:00)
2004,09,11,59129,51126,39784,11342,28.5,2004/09/11(12:00)
2004,09,10,59129,53313,43683,96300,22,2004/09/10(15:00)
2004,09,09,59129,53571,44583,8988,20.2,2004/09/09(20:00)
2004,09,08,59129,53691,44370,9321,21,2004/09/08(17:00)
2004,09,07,59129,53691,43830,9861,22.5,2004/09/07(20:00)
2004,09,06,59129,53682,45493,8189,18,2004/09/06(20:00)
2004,09,05,59129,53782,38145,15637,41,2004/09/05(20:00)
2004,09,04,59129,53939,42686,11253,26.4,2004/09/04(15:00)
2004,09,03,59129,54110,45438,8672,19.1,2004/09/03(15:00)
2004,09,02,59129,54553,46060,8493,18.4,2004/09/02(15:00)
2004,09,01,59129,55249,46594,8655,18.6,2004/09/01(15:00)
2004,08,31,59129,58260,47045,11215,23.8,2004/08/31(15:00)
2004,08,30,59129,57664,46686,10978,23.5,2004/08/30(17:00)
2004,08,29,59129,57921,38850,19071,49.1,2004/08/29(21:00)
2004,08,28,59129,58533,41393,17140,41.4,2004/08/28(12:00)
2004,08,27,59129,58271,45653,12618,27.6,2004/08/27(15:00)
2004,08,26,59129,58380,45207,13173,29.1,2004/08/26(15:00)
2004,08,25,59129,58399,45348,13051,28.8,2004/08/25(15:00)
2004,08,24,59129,58469,44796,13673,30.5,2004/08/24(16:00)
2004,08,23,59129,58240,43413,14827,34.2,2004/08/23(15:00)
2004,08,22,59129,58318,36519,21799,59.7,2004/08/22(21:00)
2004,08,21,59129,58089,41450,16639,40.1,2004/08/21(12:00)
2004,08,20,59129,58089,44228,13861,31.3,2004/08/20(12:00)
2004,08,19,59129,58318,43971,14347,32.6,2004/08/19(12:00)
2004,08,18,59129,58318,47295,11023,23.3,2004/08/18(12:00)
2004,08,17,59129,58307,48673,9634,19.8,2004/08/17(12:00)
2004,08,16,59129,58677,48001,10676,22.2,2004/08/16(12:00)
2004,08,15,59129,57835,39399,18436,46.8,2004/08/15(21:00)
2004,08,14,59129,57965,46073,11892,25.8,2004/08/14(12:00)
2004,08,13,59129,58392,51184,7208,14.1,2004/08/13(12:00)
2004,08,12,59129,58541,50487,8054,16,2004/08/12(12:00)
2004,08,11,59129,58357,50100,8257,16.5,2004/08/11(12:00)
2004,08,10,59129,58029,50795,7234,14.2,2004/08/10(12:00)
2004,08,09,59129,58021,49819,8202,16.5,2004/08/09(17:00)
2004,08,08,59129,57132,41690,15442,37,2004/08/08(21:00)
2004,08,07,59129,57132,46279,10853,23.5,2004/08/07(12:00)
2004,08,06,59129,58077,48856,9221,18.9,2004/08/06(15:00)
2004,08,05,59129,57087,47392,9695,20.5,2004/08/05(15:00)
2004,08,04,59129,58077,45731,12346,27,2004/08/04(15:00)
2004,08,03,59129,58077,43888,14189,32.3,2004/08/03(15:00)
2004,08,02,59129,58135,43118,15017,34.8,2004/08/02(15:00)
2004,08,01,59129,56561,39349,17212,43.9,2004/08/01(21:00)
2004,07,31,59129,56451,44749,11702,26.2,2004/07/31(12:00)
2004,07,30,59129,57178,50759,6419,12.6,2004/07/30(15:00)
2004,07,29,59129,57528,51264,6264,12.2,2004/07/29(15:00)
2004,07,28,58129,57052,51227,5825,11.4,2004/07/28(15:00)
2004,07,27,58129,55960,49736,6224,12.5,2004/07/27(12:00)
2004,07,26,58129,55869,48756,7113,14.6,2004/07/26(12:00)
2004,07,25,58129,56294,39760,16534,41.6,2004/07/25(21:00)
2004,07,24,58129,56728,46076,10652,23.1,2004/07/24(12:00)
2004,07,23,58129,57254,50167,7087,14.1,2004/07/23(15:00)
2004,07,22,58129,57487,49704,7783,15.7,2004/07/22(15:00)
2004,07,21,58129,56822,48880,7942,16.2,2004/07/21(17:00)
2004,07,20,58129,56442,47511,8931,18.8,2004/07/20(12:00)
2004,07,19,58129,56442,46608,9834,21.1,2004/07/19(15:00)
2004,07,18,58129,54132,38551,15581,40.4,2004/07/18(21:00)
2004,07,17,58129,53912,39544,14368,36.3,2004/07/17(21:00)
2004,07,16,58129,53774,46023,7751,16.8,2004/07/16(15:00)
2004,07,15,58129,54458,45245,9213,20.4,2004/07/15(17:00)
2004,07,14,58129,54488,45286,9202,20.3,2004/07/14(17:00)
2004,07,13,58129,53963,44875,9088,20.3,2004/07/13(15:00)
2004,07,12,58129,54225,45145,9080,20.1,2004/07/12(15:00)
2004,07,11,57328,53203,37054,16149,43.6,2004/07/11(21:00)
2004,07,10,57328,53836,41626,12210,29.3,2004/07/10(12:00)
2004,07,09,57328,54225,44954,9271,20.6,2004/07/09(15:00)
2004,07,08,57328,54089,43850,10239,23.4,2004/07/08(15:00)
2004,07,07,57328,54265,43965,10300,23.4,2004/07/07(15:00)
2004,07,06,57328,53881,45705,8176,17.9,2004/07/06(17:00)
2004,07,05,57328,53796,43834,9962,22.7,2004/07/05(17:00)
2004,07,04,57328,52470,36176,16294,45,2004/07/04(21:00)
2004,07,03,57328,51163,42381,8782,20.7,2004/07/03(15:00)
2004,07,02,57328,52412,44135,8277,18.8,2004/07/02(15:00)
2004,07,01,57328,52398,44998,7400,16.4,2004/07/01(15:00)
2004,06,30,56980,52863,45538,7325,16.1,2004/06/30(15:00)
2004,06,29,56980,53044,44489,8555,19.2,2004/06/29(15:00)
2004,06,28,56980,52779,45087,7692,17.1,2004/06/28(15:00)
2004,06,27,56980,51863,37019,14844,40.1,2004/06/27(21:00)
2004,06,26,56980,50653,41521,9132,22,2004/06/26(12:00)
2004,06,25,56980,51417,44779,6638,14.8,2004/06/25(15:00)
2004,06,24,56980,51324,45937,5387,11.7,2004/06/24(15:00)
2004,06,23,56980,50301,45167,5134,11.4,2004/06/23(17:00)
2004,06,22,56980,50131,44307,5824,13.1,2004/06/22(17:00)
2004,06,21,56980,49763,43252,6511,15.1,2004/06/21(15:00)
2004,06,20,56980,49137,36868,12269,33.3,2004/06/20(21:00)
2004,06,19,56980,48143,39662,8481,21.4,2004/06/19(12:00)
2004,06,18,56980,51370,43696,7674,17.6,2004/06/18(17:00)
2004,06,17,56980,52223,42506,9717,22.9,2004/06/17(15:00)
2004,06,16,56980,51491,45516,5975,13.1,2004/06/16(15:00)
2004,06,15,56980,50838,45708,5130,11.2,2004/06/15(15:00)
2004,06,14,56980,50725,45010,5715,12.7,2004/06/14(15:00)
2004,06,13,56980,50041,36705,13336,36.3,2004/06/13(21:00)
2004,06,12,56980,51043,42168,8875,21,2004/06/12(12:00)
2004,06,11,56980,51443,45438,6005,13.2,2004/06/11(15:00)
2004,06,10,56980,50881,44687,6194,13.9,2004/06/10(17:00)
2004,06,09,56980,50208,43276,6932,16,2004/06/09(15:00)
2004,06,08,56980,49671,42235,7436,17.6,2004/06/08(15:00)
2004,06,07,56980,49251,42679,6572,15.4,2004/06/07(15:00)
2004,06,06,56980,49790,36077,13713,38,2004/06/06(21:00)
2004,06,05,56980,49282,41534,7748,18.7,2004/06/05(12:00)
2004,06,04,56980,51744,44964,6780,15.1,2004/06/04(15:00)
2004,06,03,56980,51379,44212,7167,16.2,2004/06/03(17:00)
2004,06,02,56980,51669,42777,8892,20.8,2004/06/02(15:00)
2004,06,01,56980,52252,41816,10436,25,2004/06/01(15:00)
2004,05,31,56980,52252,41263,10989,26.6,2004/05/31(15:00)
2004,05,30,56980,52157,35648,16509,46.3,2004/05/30(21:00)
2004,05,29,56980,50868,40072,10796,26.9,2004/05/29(12:00)
2004,05,28,56980,51868,42333,9535,22.5,2004/05/28(17:00)
2004,05,27,56980,52598,42367,10231,24.1,2004/05/27(21:00)
2004,05,26,56980,53011,38819,14192,36.6,2004/05/26(23:00)
2004,05,25,56980,53146,41592,11554,27.8,2004/05/25(21:00)
2004,05,24,56980,52685,41530,11155,26.9,2004/05/24(21:00)
2004,05,23,56980,51313,36195,15118,41.8,2004/05/23(23:00)
2004,05,22,56980,50385,38516,11869,30.8,2004/05/22(23:00)
2004,05,21,56980,51502,41321,10181,24.6,2004/05/21(21:00)
2004,05,20,56980,50977,41913,9064,21.6,2004/05/20(21:00)
2004,05,19,56980,50652,41503,9149,22,2004/05/19(21:00)
2004,05,18,56980,50686,41559,9127,22,2004/05/18(21:00)
2004,05,17,56980,50581,41627,8954,21.5,2004/05/17(23:00)
2004,05,16,56980,49307,36588,12719,34.8,2004/05/16(23:00)
2004,05,15,56980,48936,39351,9585,24.4,2004/05/15(23:00)
2004,05,14,56980,48738,41281,7457,18.1,2004/05/14(21:00)
2004,05,13,56980,48162,41766,6396,15.3,2004/05/13(23:00)
2004,05,12,56980,48146,41871,6275,15,2004/05/12(23:00)
2004,05,11,56980,48024,41700,6324,15.2,2004/05/11(21:00)
2004,05,10,56980,47633,41871,5762,13.8,2004/05/10(23:00)
2004,05,09,56980,46966,37244,9722,26.1,2004/05/09(23:00)
2004,05,08,56980,44937,38971,5966,15.3,2004/05/08(23:00)
2004,05,07,56980,46783,41161,5622,13.7,2004/05/07(21:00)
2004,05,06,56980,47789,41594,6195,14.9,2004/05/06(21:00)
2004,05,05,56980,48781,39034,9747,25,2004/05/05(23:00)
2004,05,04,56980,49155,41360,7795,18.8,2004/05/04(23:00)
2004,05,03,56980,49380,41886,7494,17.9,2004/05/03(23:00)
2004,05,02,56980,49426,36389,13037,35.8,2004/05/02(23:00)
2004,05,01,56980,49400,36621,12779,34.9,2004/05/01(23:00)
2004,04,30,56980,49094,41060,8034,19.6,2004/04/30(23:00)
2004,04,29,56980,49270,41911,7359,17.6,2004/04/29(23:00)
2004,04,28,56980,48925,42107,6818,16.2,2004/04/28(23:00)
2004,04,27,56980,48168,43065,5103,11.8,2004/04/27(23:00)
2004,04,26,56980,48168,42562,5606,13.2,2004/04/26(23:00)
2004,04,25,56980,48540,36895,11645,31.6,2004/04/25(23:00)
2004,04,24,56980,48810,39618,9192,23.2,2004/04/24(23:00)
2004,04,23,56980,50046,41533,8513,20.5,2004/04/23(23:00)
2004,04,22,56980,49382,41781,7601,18.2,2004/04/22(21:00)
2004,04,21,56980,49009,41156,7853,19.1,2004/04/21(21:00)
2004,04,20,56980,49093,41250,7843,19,2004/04/20(21:00)
2004,04,19,56980,49255,41682,7573,18.2,2004/04/19(23:00)
2004,04,18,56980,48865,36115,12750,35.3,2004/04/18(23:00)
2004,04,17,56980,48865,38695,10170,26.3,2004/04/17(23:00)
2004,04,16,56980,50249,41151,9098,22.1,2004/04/16(23:00)
2004,04,15,56980,50694,39718,10976,27.6,2004/04/15(23:00)
2004,04,14,56980,50344,41381,8963,21.7,2004/04/14(23:00)
2004,04,13,56980,51239,41669,9570,23,2004/04/13(23:00)
2004,04,12,56980,50737,41777,8960,21.4,2004/04/12(23:00)
2004,04,11,56980,49486,36994,12492,33.8,2004/04/11(23:00)
2004,04,10,56980,49412,39924,9488,23.8,2004/04/10(23:00)
2004,04,09,56980,50494,42511,7983,18.8,2004/04/09(23:00)
2004,04,08,56980,52003,43276,8727,20.2,2004/04/08(23:00)
2004,04,07,56980,52100,43447,8653,19.9,2004/04/07(23:00)
2004,04,06,56980,51350,43132,8218,19.1,2004/04/06(23:00)
2004,04,05,56980,50312,39963,10349,25.9,2004/04/05(23:00)
2004,04,04,56980,49539,38420,11119,28.9,2004/04/04(01:00)
2004,04,03,56980,49539,40810,8729,21.4,2004/04/03(23:00)
2004,04,02,56980,50874,43489,7385,17,2004/04/02(23:00)
2004,04,01,56980,51431,43240,8191,18.9,2004/04/01(23:00)
2004,03,31,56980,51231,43029,8202,19.1,2004/03/31(23:00)
2004,03,30,56980,51079,43162,7917,18.3,2004/03/30(23:00)
2004,03,29,56980,50750,42609,8141,19.1,2004/03/29(23:00)
2004,03,28,56980,50073,38162,11911,31.2,2004/03/28(23:00)
2004,03,27,56980,50542,40967,9575,23.4,2004/03/27(23:00)
2004,03,26,56980,50782,43433,7349,16.9,2004/03/26(23:00)
2004,03,25,56980,51054,43833,7221,16.5,2004/03/25(23:00)
2004,03,24,56980,50677,43755,6922,15.8,2004/03/24(23:00)
2004,03,23,56980,50107,43684,6423,14.7,2004/03/23(23:00)
2004,03,22,56980,49957,43685,6272,14.4,2004/03/22(23:00)
2004,03,21,56980,49189,39080,10109,25.9,2004/03/21(01:00)
2004,03,20,56951,49355,41587,7768,18.7,2004/03/20(23:00)
2004,03,19,56951,51557,44387,7170,16.2,2004/03/19(23:00)
2004,03,18,56951,51543,44818,6725,15,2004/03/18(23:00)
2004,03,17,56501,52190,44567,7623,17.1,2004/03/17(23:00)
2004,03,16,56501,52045,43034,9011,20.9,2004/03/16(23:00)
2004,03,15,56501,51724,43685,8039,18.4,2004/03/15(23:00)
2004,03,14,56501,50284,39550,10734,27.1,2004/03/14(23:00)
2004,03,13,56501,51076,41687,9389,22.5,2004/03/13(23:00)
2004,03,12,56501,51035,43975,7060,16.1,2004/03/12(23:00)
2004,03,11,56501,51785,44268,7517,17,2004/03/11(23:00)
2004,03,10,56501,51260,44074,7186,16.3,2004/03/10(23:00)
2004,03,09,56501,51784,44825,6959,15.5,2004/03/09(23:00)
2004,03,08,56501,51512,45251,6261,13.8,2004/03/08(23:00)
2004,03,07,56501,50114,42573,7541,17.7,2004/03/07(01:00)
2004,03,06,56501,49354,43745,5609,12.8,2004/03/06(24:00)
2004,03,05,56501,50635,44976,5659,12.6,2004/03/05(23:00)
2004,03,04,56494,50017,45460,4557,10,2004/03/04(23:00)
2004,03,03,56494,50528,45406,5122,11.3,2004/03/03(23:00)
2004,03,02,56494,49999,44929,5070,11.3,2004/03/02(23:00)
2004,03,01,56494,49520,41122,8398,20.4,2004/03/01(24:00)
2004,02,29,56494,49504,40097,9407,23.5,2004/02/29(01:00)
2004,02,28,56494,50496,42409,8087,19.1,2004/02/28(01:00)
2004,02,27,56494,51371,44466,6905,15.5,2004/02/27(23:00)
2004,02,26,56494,51371,44887,6484,14.4,2004/02/26(23:00)
2004,02,25,56494,50640,44329,6311,14.2,2004/02/25(23:00)
2004,02,24,56494,50623,44294,6329,14.3,2004/02/24(23:00)
2004,02,23,56494,50633,44484,6149,13.8,2004/02/23(23:00)
2004,02,22,56494,49737,39506,10231,25.9,2004/02/22(24:00)
2004,02,21,56494,50613,40720,9893,24.3,2004/02/21(23:00)
2004,02,20,56494,51569,43367,8202,18.9,2004/02/20(23:00)
2004,02,19,56494,51579,44216,7363,16.7,2004/02/19(23:00)
2004,02,18,56494,51850,44345,7505,16.9,2004/02/18(23:00)
2004,02,17,56494,51850,44604,7246,16.2,2004/02/17(23:00)
2004,02,16,56494,52029,44552,7477,16.8,2004/02/16(23:00)
2004,02,15,56494,51366,41682,9684,23.2,2004/02/15(01:00)
2004,02,14,55989,51577,42918,8659,20.2,2004/02/14(24:00)
2004,02,13,55989,52199,44666,7533,16.9,2004/02/13(23:00)
2004,02,12,55989,52199,45300,6899,15.2,2004/02/12(24:00)
2004,02,11,55989,52199,45113,7086,15.7,2004/02/11(23:00)
2004,02,10,55989,52082,45583,6499,14.3,2004/02/10(24:00)
2004,02,09,55989,52002,45599,6403,14,2004/02/09(24:00)
2004,02,08,55989,50965,43065,7900,18.3,2004/02/08(01:00)
2004,02,07,55989,51507,44726,6781,15.2,2004/02/07(01:00)
2004,02,06,55989,51772,46148,5624,12.2,2004/02/06(24:00)
2004,02,05,55989,51772,46387,5385,11.6,2004/02/05(24:00)
2004,02,04,55989,51216,45797,5419,11.8,2004/02/04(24:00)
2004,02,03,55989,51223,46104,5119,11.1,2004/02/03(24:00)
2004,02,02,55989,51329,45834,5495,12,2004/02/02(24:00)
2004,02,01,55989,50212,41681,8531,20.5,2004/02/01(01:00)
2004,01,31,55989,50532,43758,6774,15.5,2004/01/31(01:00)
2004,01,30,55989,51075,45278,5797,12.8,2004/01/30(24:00)
2004,01,29,55989,51534,45711,5823,12.7,2004/01/29(24:00)
2004,01,28,55989,51775,45732,6043,13.2,2004/01/28(24:00)
2004,01,27,55989,51775,46222,5553,12,2004/01/27(19:00)
2004,01,26,55989,51506,45865,5641,12.3,2004/01/26(24:00)
2004,01,25,55989,52495,40998,11497,28,2004/01/25(24:00)
2004,01,24,55989,52495,39210,13285,33.9,2004/01/24(24:00)
2004,01,23,55989,52760,36717,16043,43.7,2004/01/23(24:00)
2004,01,22,55989,52003,36384,15619,42.9,2004/01/22(01:00)
2004,01,21,55989,53030,40857,12173,29.8,2004/01/21(01:00)
2004,01,20,55989,53251,43590,9661,22.2,2004/01/20(01:00)
2004,01,19,55989,52973,45205,7768,17.2,2004/01/19(24:00)
2004,01,18,55989,52296,42447,9849,23.2,2004/01/18(01:00)
2004,01,17,55989,52652,43779,8873,20.3,2004/01/17(01:00)
2004,01,16,55989,53108,45262,7846,17.3,2004/01/16(24:00)
2004,01,15,55989,52852,45824,7028,15.3,2004/01/15(23:00)
2004,01,14,55989,53230,45811,7419,16.2,2004/01/14(24:00)
2004,01,13,55989,53076,46273,6803,14.7,2004/01/13(19:00)
2004,01,12,55989,53058,45490,7568,16.6,2004/01/12(24:00)
2004,01,11,55989,52625,41663,10962,26.3,2004/01/11(01:00)
2004,01,10,55989,52510,43103,9407,21.8,2004/01/10(01:00)
2004,01,09,55989,53049,44755,8294,18.5,2004/01/09(23:00)
2004,01,08,55989,53064,45107,7957,17.6,2004/01/08(19:00)
2004,01,07,55989,53495,44876,8619,19.2,2004/01/07(24:00)
2004,01,06,55989,52886,44261,8625,19.5,2004/01/06(24:00)
2004,01,05,55989,52896,44603,8293,18.6,2004/01/05(23:00)
2004,01,04,55989,50667,40232,10435,25.9,2004/01/04(24:00)
2004,01,03,55989,50867,41521,9346,22.5,2004/01/03(24:00)
2004,01,02,55989,52473,42136,10337,24.5,2004/01/02(24:00)
2004,01,01,55989,52717,39638,13079,33,2004/01/01(01:00)
2003,12,31,56048,53655,42526,11129,26.2,2003/12/31(01:00)
2003,12,30,56048,53655,44128,9527,21.6,2003/12/30(23:00)
2003,12,29,56048,53655,44689,8966,20.1,2003/12/29(19:00)
2003,12,28,56048,53723,42307,11416,27,2003/12/28(01:00)
2003,12,27,56048,55038,44167,10871,24.6,2003/12/27(01:00)
2003,12,26,56048,54736,45441,9295,20.5,2003/12/26(24:00)
2003,12,25,56048,54736,42751,11985,28,2003/12/25(01:00)
2003,12,24,56048,54370,44119,10251,23.2,2003/12/24(24:00)
2003,12,23,56048,54182,44990,9192,20.4,2003/12/23(23:00)
2003,12,22,56048,53582,45205,8377,18.5,2003/12/22(23:00)
2003,12,21,56048,53658,42779,10879,25.4,2003/12/21(01:00)
2003,12,20,56048,54169,44869,9300,20.7,2003/12/20(01:00)
2003,12,19,56048,54431,46134,8297,18,2003/12/19(19:00)
2003,12,18,56048,54230,45648,8582,18.8,2003/12/18(24:00)
2003,12,17,56048,53980,45315,8665,19.1,2003/12/17(23:00)
2003,12,16,56048,53980,45200,8780,19.4,2003/12/16(19:00)
2003,12,15,56048,54156,45328,8828,19.5,2003/12/15(19:00)
2003,12,14,56045,53177,41336,11841,28.6,2003/12/14(01:00)
2003,12,13,56045,53295,43287,10008,23.1,2003/12/13(01:00)
2003,12,12,56045,53762,44919,8843,19.7,2003/12/12(19:00)
2003,12,11,56045,53762,44795,8967,20,2003/12/11(19:00)
2003,12,10,56045,53762,44810,8952,20,2003/12/10(23:00)
2003,12,09,56045,53472,45375,8097,17.8,2003/12/09(19:00)
2003,12,08,56045,53330,45000,8330,18.5,2003/12/08(19:00)
2003,12,07,56045,52330,40606,11724,28.9,2003/12/07(01:00)
2003,12,06,56045,52717,41913,10804,25.8,2003/12/06(24:00)
2003,12,05,56045,53281,43461,9820,22.6,2003/12/05(23:00)
2003,12,04,56045,52433,44351,8082,18.2,2003/12/04(19:00)
2003,12,03,56045,52433,43565,8868,20.4,2003/12/03(23:00)
2003,12,02,56045,52233,43297,8936,20.6,2003/12/02(19:00)
2003,12,01,56045,52362,43028,9334,21.7,2003/12/01(23:00)
2003,11,30,56045,52006,38289,13717,35.8,2003/11/30(01:00)
2003,11,29,56045,52264,40352,11912,29.5,2003/11/29(23:00)
2003,11,28,56045,53150,42614,10536,24.7,2003/11/28(23:00)
2003,11,27,56045,53013,43230,9783,22.6,2003/11/27(19:00)
2003,11,26,56045,52305,43142,9163,21.2,2003/11/26(23:00)
2003,11,25,56045,51732,43579,8153,18.7,2003/11/25(19:00)
2003,11,24,56045,52311,43822,8489,19.4,2003/11/24(19:00)
2003,11,23,56045,52357,40095,12262,30.6,2003/11/23(01:00)
2003,11,22,56045,52235,41462,10773,26,2003/11/22(24:00)
2003,11,21,56045,52351,43398,8953,20.6,2003/11/21(23:00)
2003,11,20,56045,52641,42876,9765,22.8,2003/11/20(19:00)
2003,11,19,56045,52026,42337,9689,22.9,2003/11/19(23:00)
2003,11,18,56045,52945,42903,10042,23.4,2003/11/18(19:00)
2003,11,17,56045,52757,42863,9894,23.1,2003/11/17(19:00)
2003,11,16,56045,52861,37786,15075,39.9,2003/11/16(23:00)
2003,11,15,56045,53051,40015,13036,32.6,2003/11/15(23:00)
2003,11,14,56045,53409,42588,10821,25.4,2003/11/14(19:00)
2003,11,13,56045,53473,42777,10696,25,2003/11/13(19:00)
2003,11,12,56045,53473,42321,11152,26.4,2003/11/12(23:00)
2003,11,11,56045,53473,42717,10756,25.2,2003/11/11(19:00)
2003,11,10,56045,53473,42191,11282,26.7,2003/11/10(19:00)
2003,11,09,56045,54013,36932,17081,46.2,2003/11/09(23:00)
2003,11,08,56045,54003,39257,14746,37.6,2003/11/08(23:00)
2003,11,07,56045,53306,41872,11434,27.3,2003/11/07(19:00)
2003,11,06,56045,53052,41851,11201,26.8,2003/11/06(19:00)
2003,11,05,56045,52952,41313,11639,28.2,2003/11/05(19:00)
2003,11,04,56045,52952,41778,11174,26.7,2003/11/04(19:00)
2003,11,03,56045,53792,41262,12530,30.4,2003/11/03(19:00)
2003,11,02,56045,53130,36007,17123,47.6,2003/11/02(23:00)
2003,11,01,56045,53640,38628,15012,38.9,2003/11/01(23:00)
2003,10,31,56045,53898,41338,12560,30.4,2003/10/31(19:00)
2003,10,30,56045,53898,42135,11763,27.9,2003/10/30(19:00)
2003,10,29,56045,53898,42053,11845,28.2,2003/10/29(19:00)
2003,10,28,56045,53028,42467,10561,24.9,2003/10/28(19:00)
2003,10,27,56045,53244,41716,11528,27.6,2003/10/27(19:00)
2003,10,26,56045,53223,36638,16585,45.3,2003/10/26(23:00)
2003,10,25,56045,53343,39021,14322,36.7,2003/10/25(23:00)
2003,10,24,56045,53933,41372,12561,30.4,2003/10/24(19:00)
2003,10,23,56045,53811,42166,11645,27.6,2003/10/23(19:00)
2003,10,22,56045,53561,41300,12261,29.7,2003/10/22(23:00)
2003,10,21,56045,53361,41952,11409,27.2,2003/10/21(19:00)
2003,10,20,56045,53361,41500,11861,28.6,2003/10/20(19:00)
2003,10,19,56045,51657,35846,15811,44.1,2003/10/19(23:00)
2003,10,18,56045,52547,38320,14227,37.1,2003/10/18(23:00)
2003,10,17,56045,52449,41016,11433,27.9,2003/10/17(19:00)
2003,10,16,56045,52389,41114,11275,27.4,2003/10/16(19:00)
2003,10,15,56045,52499,40667,11832,29.1,2003/10/15(23:00)
2003,10,14,56045,52509,41332,11177,27,2003/10/14(19:00)
2003,10,13,56045,52509,40882,11627,28.4,2003/10/13(19:00)
2003,10,12,56045,52111,35510,16601,46.8,2003/10/12(23:00)
2003,10,11,56045,51277,38303,12974,33.9,2003/10/11(12:00)
2003,10,10,56045,51907,41174,10733,26.1,2003/10/10(20:00)
2003,10,09,56045,53027,41428,11599,28,2003/10/09(20:00)
2003,10,08,56045,53027,40573,12454,30.7,2003/10/08(19:00)
2003,10,07,56045,52420,41004,11416,27.8,2003/10/07(20:00)
2003,10,06,56045,52241,40662,11579,28.5,2003/10/06(20:00)
2003,10,05,56045,53148,34703,18445,53.2,2003/10/05(23:00)
2003,10,04,56045,52931,36717,16214,44.2,2003/10/04(23:00)
2003,10,03,56045,53090,37501,15589,41.6,2003/10/03(23:00)
2003,10,02,56045,52896,39927,12969,32.5,2003/10/02(20:00)
2003,10,01,56045,52573,40116,12457,31.1,2003/10/01(20:00)
2003,09,30,56081,52956,40914,12042,29.4,2003/09/30(20:00)
2003,09,29,56081,52956,40915,12041,29.4,2003/09/29(20:00)
2003,09,28,56081,52874,34807,18067,51.9,2003/09/28(23:00)
2003,09,27,56081,52352,38526,13826,35.9,2003/09/27(12:00)
2003,09,26,56081,52328,41492,10836,26.1,2003/09/26(20:00)
2003,09,25,56081,52114,41351,10763,26,2003/09/25(20:00)
2003,09,24,56081,51604,40321,11283,28,2003/09/24(20:00)
2003,09,23,56081,51705,40804,10901,26.7,2003/09/23(20:00)
2003,09,22,56081,51849,40465,11384,28.1,2003/09/22(20:00)
2003,09,21,56081,51631,34360,17271,50.3,2003/09/21(23:00)
2003,09,20,56081,48786,38508,10278,26.7,2003/09/20(12:00)
2003,09,19,56081,50042,41620,8422,20.2,2003/09/19(20:00)
2003,09,18,56081,50042,42858,7184,16.8,2003/09/18(15:00)
2003,09,17,56081,49870,43314,6556,15.1,2003/09/17(15:00)
2003,09,16,56081,49473,42673,6800,15.9,2003/09/16(20:00)
2003,09,15,56081,47212,40901,6311,15.4,2003/09/15(20:00)
2003,09,14,56081,47984,33389,14595,43.7,2003/09/14(21:00)
2003,09,13,56081,47984,31181,16803,53.9,2003/09/13(21:00)
2003,09,12,56081,52046,27756,24290,87.5,2003/09/12(20:00)
2003,09,11,56081,51955,26916,25039,93,2003/09/11(23:00)
2003,09,10,56081,52471,31712,20759,65.5,2003/09/10(01:00)
2003,09,09,56081,52692,40705,11987,29.4,2003/09/09(12:00)
2003,09,08,56081,52582,44412,8170,18.4,2003/09/08(15:00)
2003,09,07,56081,52308,38283,14025,36.6,2003/09/07(21:00)
2003,09,06,56081,52308,41910,10398,24.8,2003/09/06(12:00)
2003,09,05,56081,52635,44880,7755,17.3,2003/09/05(15:00)
2003,09,04,56081,52592,44191,8401,19,2003/09/04(20:00)
2003,09,03,56081,52450,42888,9562,22.3,2003/09/03(15:00)
2003,09,02,56081,52019,42057,9962,23.7,2003/09/02(20:00)
2003,09,01,56081,52775,41888,10887,26,2003/09/01(20:00)
2003,08,31,56081,52541,34564,17977,52,2003/08/31(21:00)
2003,08,30,56081,52986,39933,13053,32.7,2003/08/30(12:00)
2003,08,29,56081,54176,42649,11527,27,2003/08/29(15:00)
2003,08,28,56081,54166,43985,10181,23.1,2003/08/28(15:00)
2003,08,27,56081,54176,42201,11975,28.4,2003/08/27(12:00)
2003,08,26,56081,54877,44314,10563,23.8,2003/08/26(15:00)
2003,08,25,56081,54887,44718,10169,22.7,2003/08/25(15:00)
2003,08,24,56081,54050,37125,16925,45.6,2003/08/24(21:00)
2003,08,23,56081,54165,43491,10674,24.5,2003/08/23(12:00)
2003,08,22,56081,55488,47385,8103,17.1,2003/08/22(12:00)
2003,08,21,56081,55488,45982,9506,20.7,2003/08/21(12:00)
2003,08,20,56081,55488,44283,11205,25.3,2003/08/20(12:00)
2003,08,19,56081,55488,41858,13630,32.6,2003/08/19(20:00)
2003,08,18,56081,55488,40681,14807,36.4,2003/08/18(12:00)
2003,08,17,56081,55254,34121,21133,61.9,2003/08/17(21:00)
2003,08,16,56081,55254,36855,18399,49.9,2003/08/16(12:00)
2003,08,15,56081,55488,37476,18012,48.1,2003/08/15(21:00)
2003,08,14,56081,55448,42440,13008,30.7,2003/08/14(12:00)
2003,08,13,56081,55448,41942,13506,32.2,2003/08/13(12:00)
2003,08,12,56081,55448,42839,12609,29.4,2003/08/12(12:00)
2003,08,11,56081,55488,41755,13733,32.9,2003/08/11(12:00)
2003,08,10,56081,54681,35339,19342,54.7,2003/08/10(21:00)
2003,08,09,56081,55054,40316,14738,36.6,2003/08/09(12:00)
2003,08,08,56081,55288,41628,13660,32.8,2003/08/08(12:00)
2003,08,07,56081,55218,40365,14853,36.8,2003/08/07(12:00)
2003,08,06,56081,54121,42811,11310,26.4,2003/08/06(12:00)
2003,08,05,56081,53851,43728,10123,23.1,2003/08/05(15:00)
2003,08,04,56081,54451,42207,12244,29,2003/08/04(15:00)
2003,08,03,56081,54451,36141,18310,50.7,2003/08/03(21:00)
2003,08,02,56081,55235,36038,19197,53.3,2003/08/02(21:00)
2003,08,01,56081,55724,37626,18098,48.1,2003/08/01(15:00)
2003,07,31,56081,55468,39668,15800,39.8,2003/07/31(15:00)
2003,07,30,56081,55724,41298,14426,34.9,2003/07/30(15:00)
2003,07,29,56071,55448,41145,14303,34.8,2003/07/29(15:00)
2003,07,28,56071,55818,39655,16163,40.8,2003/07/28(15:00)
2003,07,27,56071,55323,34119,21204,62.1,2003/07/27(21:00)
2003,07,26,56071,55023,40087,14936,37.3,2003/07/26(12:00)
2003,07,25,56071,55818,42485,13333,31.4,2003/07/25(12:00)
2003,07,24,56071,55818,42301,13517,32,2003/07/24(12:00)
2003,07,23,56071,55743,42420,13323,31.4,2003/07/23(12:00)
2003,07,22,56071,55743,42199,13544,32.1,2003/07/22(12:00)
2003,07,21,56071,55818,42160,13658,32.4,2003/07/21(12:00)
2003,07,20,56071,55833,34878,20955,60.1,2003/07/20(21:00)
2003,07,19,56071,55421,37289,18132,48.6,2003/07/19(12:00)
2003,07,18,56071,55808,39704,16104,40.6,2003/07/18(15:00)
2003,07,17,56071,55298,37364,17934,48,2003/07/17(21:00)
2003,07,16,56071,55808,43027,12781,29.7,2003/07/16(15:00)
2003,07,15,56071,55723,42510,13213,31.1,2003/07/15(15:00)
2003,07,14,56071,55598,40852,14746,36.1,2003/07/14(15:00)
2003,07,13,56071,55608,34307,21301,62.1,2003/07/13(21:00)
2003,07,12,56071,55292,39070,16222,41.5,2003/07/12(12:00)
2003,07,11,56071,55548,42078,13470,32,2003/07/11(15:00)
2003,07,10,56071,55463,42169,13294,31.5,2003/07/10(15:00)
2003,07,09,56071,55463,42071,13392,31.8,2003/07/09(15:00)
2003,07,08,56071,55508,42156,13352,31.7,2003/07/08(15:00)
2003,07,07,56071,55082,41566,13516,32.5,2003/07/07(15:00)
2003,07,06,56071,55294,34736,20558,59.2,2003/07/06(21:00)
2003,07,05,56071,54919,38712,16207,41.9,2003/07/05(12:00)
2003,07,04,56071,54836,40197,14639,36.4,2003/07/04(15:00)
2003,07,03,56071,54412,39778,14634,36.8,2003/07/03(21:00)
2003,07,02,56071,54708,41999,12709,30.3,2003/07/02(15:00)
2003,07,01,56071,53908,40844,13064,32,2003/07/01(15:00)
2003,06,30,56071,52816,40992,11824,28.8,2003/06/30(15:00)
2003,06,29,56071,51815,33952,17863,52.6,2003/06/29(21:00)
2003,06,28,56071,51369,38565,12804,33.2,2003/06/28(12:00)
2003,06,27,56071,50874,40003,10871,27.2,2003/06/27(15:00)
2003,06,26,56071,50604,41163,9441,22.9,2003/06/26(15:00)
2003,06,25,56071,49952,39492,10460,26.5,2003/06/25(15:00)
2003,06,24,56071,49441,39913,9528,23.9,2003/06/24(15:00)
2003,06,23,56071,50214,41347,8867,21.4,2003/06/23(17:00)
2003,06,22,56071,49372,35552,13820,38.9,2003/06/22(21:00)
2003,06,21,56071,50386,39607,10779,27.2,2003/06/21(12:00)
2003,06,20,55619,51606,42037,9569,22.8,2003/06/20(15:00)
2003,06,19,55619,50941,41044,9897,24.1,2003/06/19(15:00)
2003,06,18,55619,51046,41907,9139,21.8,2003/06/18(15:00)
2003,06,17,55619,50546,41088,9458,23,2003/06/17(15:00)
2003,06,16,55619,49728,40400,9328,23.1,2003/06/16(15:00)
2003,06,15,55619,49545,33803,15742,46.6,2003/06/15(21:00)
2003,06,14,55619,49710,38123,11587,30.4,2003/06/14(12:00)
2003,06,13,55619,50066,40038,10028,25,2003/06/13(15:00)
2003,06,12,55619,50338,40194,10144,25.2,2003/06/12(21:00)
2003,06,11,55619,50080,40807,9273,22.7,2003/06/11(15:00)
2003,06,10,55619,50350,40781,9569,23.5,2003/06/10(15:00)
2003,06,09,55619,49642,42030,7612,18.1,2003/06/09(17:00)
2003,06,08,55619,49402,34384,15018,43.7,2003/06/08(21:00)
2003,06,07,55619,49327,36111,13216,36.6,2003/06/07(21:00)
2003,06,06,55619,49576,36125,13451,37.2,2003/06/06(21:00)
2003,06,05,55619,49776,40911,8865,21.7,2003/06/05(15:00)
2003,06,04,55619,50059,39967,10092,25.3,2003/06/04(15:00)
2003,06,03,55619,49820,39627,10193,25.7,2003/06/03(15:00)
2003,06,02,55619,49581,39719,9862,24.8,2003/06/02(15:00)
2003,06,01,55619,49341,33240,16101,48.4,2003/06/01(23:00)
2003,05,31,55619,47713,37980,9733,25.6,2003/05/31(12:00)
2003,05,30,55619,48837,39810,9027,22.7,2003/05/30(15:00)
2003,05,29,55619,48682,39953,8729,21.8,2003/05/29(15:00)
2003,05,28,55619,47292,40679,6613,16.3,2003/05/28(15:00)
2003,05,27,55619,47433,40225,7208,17.9,2003/05/27(15:00)
2003,05,26,55619,47388,39424,7964,20.2,2003/05/26(21:00)
2003,05,25,55619,47277,34158,13119,38.4,2003/05/25(23:00)
2003,05,24,55619,47091,37623,9468,25.2,2003/05/24(12:00)
2003,05,23,55619,47091,39295,7796,19.8,2003/05/23(21:00)
2003,05,22,55619,46699,39485,7214,18.3,2003/05/22(21:00)
2003,05,21,55619,46515,39140,7375,18.8,2003/05/21(21:00)
2003,05,20,55619,46058,38776,7282,18.8,2003/05/20(21:00)
2003,05,19,55619,46058,39132,6926,17.7,2003/05/19(21:00)
2003,05,18,55151,46544,33414,13130,39.3,2003/05/18(23:00)
2003,05,17,55151,46334,36505,9829,26.9,2003/05/17(12:00)
2003,05,16,55151,47082,38696,8386,21.7,2003/05/16(21:00)
2003,05,15,55151,48532,39417,9115,23.1,2003/05/15(23:00)
2003,05,14,55151,47579,39062,8517,21.8,2003/05/14(21:00)
2003,05,13,55151,47829,39324,8505,21.6,2003/05/13(21:00)
2003,05,12,55151,47829,38939,8890,22.8,2003/05/12(21:00)
2003,05,11,55151,48296,33857,14439,42.6,2003/05/11(23:00)
2003,05,10,55151,48391,36448,11943,32.8,2003/05/10(23:00)
2003,05,09,55151,48961,38665,10296,26.6,2003/05/09(23:00)
2003,05,08,55151,49530,37212,12318,33.1,2003/05/08(23:00)
2003,05,07,55151,48733,39027,9706,24.9,2003/05/07(23:00)
2003,05,06,55151,48433,38671,9762,25.2,2003/05/06(23:00)
2003,05,05,55151,48568,33899,14669,43.3,2003/05/05(23:00)
2003,05,04,55151,46672,32699,13973,42.7,2003/05/04(23:00)
2003,05,03,55151,48124,35395,12729,36,2003/05/03(23:00)
2003,05,02,55151,48689,37233,11456,30.8,2003/05/02(23:00)
2003,05,01,55151,49418,36239,13179,36.4,2003/05/01(23:00)
2003,04,30,55151,49064,38897,10167,26.1,2003/04/30(23:00)
2003,04,29,55151,48700,39520,9180,23.2,2003/04/29(23:00)
2003,04,28,55151,47777,38686,9091,23.5,2003/04/28(23:00)
2003,04,27,55151,47339,34415,12924,37.6,2003/04/27(23:00)
2003,04,26,55151,46948,37234,9714,26.1,2003/04/26(23:00)
2003,04,25,55151,46933,39733,7200,18.1,2003/04/25(23:00)
2003,04,24,55151,47094,39885,7209,18.1,2003/04/24(23:00)
2003,04,23,55151,48571,39952,8619,21.6,2003/04/23(23:00)
2003,04,22,55151,49016,39954,9062,22.7,2003/04/22(23:00)
2003,04,21,55151,48969,39898,9071,22.7,2003/04/21(23:00)
2003,04,20,55151,48684,35474,13210,37.2,2003/04/20(23:00)
2003,04,19,55151,49220,37609,11611,30.9,2003/04/19(23:00)
2003,04,18,55151,48680,39351,9329,23.7,2003/04/18(23:00)
2003,04,17,55151,46925,39035,7890,20.2,2003/04/17(21:00)
2003,04,16,55151,46856,39383,7473,19,2003/04/16(23:00)
2003,04,15,55151,48786,39850,8936,22.4,2003/04/15(23:00)
2003,04,14,55151,50036,39899,10137,25.4,2003/04/14(23:00)
2003,04,13,55151,50081,35351,14730,41.7,2003/04/13(23:00)
2003,04,12,55151,50007,38142,11865,31.1,2003/04/12(23:00)
2003,04,11,55151,50269,40632,9637,23.7,2003/04/11(23:00)
2003,04,10,55151,50039,40321,9718,24.1,2003/04/10(23:00)
2003,04,09,55151,50039,40838,9201,22.5,2003/04/09(23:00)
2003,04,08,55151,50039,40699,9340,22.9,2003/04/08(23:00)
2003,04,07,55151,49218,40083,9135,22.8,2003/04/07(23:00)
2003,04,06,55151,48810,34731,14079,40.5,2003/04/06(23:00)
2003,04,05,55151,48252,36534,11718,32.1,2003/04/05(23:00)
2003,04,04,55151,47790,39672,8118,20.5,2003/04/04(23:00)
2003,04,03,55151,48306,39851,8455,21.2,2003/04/03(23:00)
2003,04,02,55151,47635,39848,7787,19.5,2003/04/02(23:00)
2003,04,01,55151,48127,39901,8226,20.6,2003/04/01(23:00)
2003,03,31,55151,47969,40030,7939,19.8,2003/03/31(23:00)
2003,03,30,55151,47942,36385,11557,31.8,2003/03/30(01:00)
2003,03,29,55151,48542,38732,9810,25.3,2003/03/29(23:00)
2003,03,28,55151,50521,41234,9287,22.5,2003/03/28(23:00)
2003,03,27,55151,50949,41385,9564,23.1,2003/03/27(23:00)
2003,03,26,55151,50949,40713,10236,25.1,2003/03/26(23:00)
2003,03,25,55151,50949,41244,9705,23.5,2003/03/25(23:00)
2003,03,24,55151,50767,41056,9711,23.7,2003/03/24(23:00)
2003,03,23,55151,50455,36609,13846,37.8,2003/03/23(01:00)
2003,03,22,55151,50790,38818,11972,30.8,2003/03/22(23:00)
2003,03,21,55151,50583,41211,9372,22.7,2003/03/21(23:00)
2003,03,20,55151,50643,41565,9078,21.8,2003/03/20(23:00)
2003,03,19,55151,50127,41500,8627,20.8,2003/03/19(23:00)
2003,03,18,55151,50127,41639,8488,20.4,2003/03/18(23:00)
2003,03,17,55151,49735,41613,8122,19.5,2003/03/17(23:00)
2003,03,16,55151,49635,37518,12117,32.3,2003/03/16(01:00)
2003,03,15,55151,50229,39564,10665,27,2003/03/15(01:00)
2003,03,14,55151,50990,41774,9216,22.1,2003/03/14(23:00)
2003,03,13,55151,51113,41787,9326,22.3,2003/03/13(23:00)
2003,03,12,55151,50913,41856,9057,21.6,2003/03/12(23:00)
2003,03,11,55151,50280,41577,8703,20.9,2003/03/11(23:00)
2003,03,10,55151,50476,42201,8275,19.6,2003/03/10(23:00)
2003,03,09,55151,49879,39453,10426,26.4,2003/03/09(01:00)
2003,03,08,55151,50773,41205,9568,23.2,2003/03/08(01:00)
2003,03,07,55151,51811,42506,9305,21.9,2003/03/07(23:00)
2003,03,06,55151,51699,42506,9193,21.6,2003/03/06(23:00)
2003,03,05,55151,51822,42545,9277,21.8,2003/03/05(23:00)
2003,03,04,55151,51709,42699,9010,21.1,2003/03/04(23:00)
2003,03,03,55151,51709,42565,9144,21.5,2003/03/03(23:00)
2003,03,02,55151,50860,37440,13420,35.8,2003/03/02(01:00)
2003,03,01,55151,50864,38987,11877,30.5,2003/03/01(01:00)
2003,02,28,55151,52191,40914,11277,27.6,2003/02/28(23:00)
2003,02,27,55151,52206,41967,10239,24.4,2003/02/27(23:00)
2003,02,26,55151,52026,42036,9990,23.8,2003/02/26(23:00)
2003,02,25,55151,51962,42244,9718,23,2003/02/25(23:00)
2003,02,24,55151,51698,42270,9428,22.3,2003/02/24(23:00)
2003,02,23,55151,50437,39389,11048,28,2003/02/23(01:00)
2003,02,22,55151,51387,41112,10275,25,2003/02/22(01:00)
2003,02,21,55151,51674,42696,8978,21,2003/02/21(23:00)
2003,02,20,55151,50964,42739,8225,19.2,2003/02/20(23:00)
2003,02,19,55151,50934,42811,8123,19,2003/02/19(23:00)
2003,02,18,55151,50418,42578,7840,18.4,2003/02/18(23:00)
2003,02,17,55151,50829,42609,8220,19.3,2003/02/17(23:00)
2003,02,16,55151,50626,39268,11358,28.9,2003/02/16(01:00)
2003,02,15,55151,51380,41902,9478,22.6,2003/02/15(01:00)
2003,02,14,55151,51542,43115,8427,19.5,2003/02/14(23:00)
2003,02,13,55151,51552,43202,8350,19.3,2003/02/13(24:00)
2003,02,12,55151,50802,43574,7228,16.6,2003/02/12(24:00)
2003,02,11,55151,50798,43230,7568,17.5,2003/02/11(24:00)
2003,02,10,55151,50309,42318,7991,18.9,2003/02/10(23:00)
2003,02,09,55151,49958,40363,9595,23.8,2003/02/09(01:00)
2003,02,08,55151,49958,41372,8586,20.8,2003/02/08(01:00)
2003,02,07,55151,50216,42702,7514,17.6,2003/02/07(23:00)
2003,02,06,55151,50216,43025,7191,16.7,2003/02/06(24:00)
2003,02,05,55151,51196,43035,8161,19,2003/02/05(24:00)
2003,02,04,55151,49888,41903,7985,19.1,2003/02/04(24:00)
2003,02,03,55151,50152,37539,12613,33.6,2003/02/03(24:00)
2003,02,02,55151,49952,33677,16275,48.3,2003/02/02(24:00)
2003,02,01,55151,49952,33663,16289,48.4,2003/02/01(01:00)
2003,01,31,55151,51577,39513,12064,30.5,2003/01/31(01:00)
2003,01,30,55151,52340,43620,8720,20,2003/01/30(01:00)
2003,01,29,55151,52340,44536,7804,17.5,2003/01/29(24:00)
2003,01,28,55151,52537,44633,7904,17.7,2003/01/28(24:00)
2003,01,27,55151,52667,44320,8347,18.8,2003/01/27(19:00)
2003,01,26,55151,52657,41009,11648,28.4,2003/01/26(01:00)
2003,01,25,55151,52657,42997,9660,22.5,2003/01/25(01:00)
2003,01,24,55151,52972,43888,9084,20.7,2003/01/24(24:00)
2003,01,23,55151,52197,44042,8155,18.5,2003/01/23(19:00)
2003,01,22,55151,51981,44011,7970,18.1,2003/01/22(24:00)
2003,01,21,55151,51981,43799,8182,18.7,2003/01/21(19:00)
2003,01,20,55151,51758,44004,7754,17.6,2003/01/20(19:00)
2003,01,19,55151,51510,40219,11291,28.1,2003/01/19(01:00)
2003,01,18,55151,51571,41757,9814,23.5,2003/01/18(01:00)
2003,01,17,55151,51371,43124,8247,19.1,2003/01/17(19:00)
2003,01,16,53800,51180,43927,7253,16.5,2003/01/16(19:00)
2003,01,15,53801,51498,43809,7689,17.6,2003/01/15(19:00)
2003,01,14,53801,51498,44411,7087,16,2003/01/14(19:00)
2003,01,13,53801,51423,43254,8169,18.9,2003/01/13(19:00)
2003,01,12,53801,51433,40742,10691,26.2,2003/01/12(01:00)
2003,01,11,53801,51952,42943,9009,21,2003/01/11(01:00)
2003,01,10,53801,51952,43608,8344,19.1,2003/01/10(19:00)
2003,01,09,53801,52627,44373,8254,18.6,2003/01/09(19:00)
2003,01,08,53801,52727,44293,8434,19,2003/01/08(19:00)
2003,01,07,53801,52477,45046,7431,16.5,2003/01/07(19:00)
2003,01,06,53801,52001,45023,6978,15.5,2003/01/06(19:00)
2003,01,05,53801,53552,41733,11819,28.3,2003/01/05(01:00)
2003,01,04,53801,53318,42162,11156,26.5,2003/01/04(01:00)
2003,01,03,53801,53328,42866,10462,24.4,2003/01/03(19:00)
2003,01,02,53801,53533,41084,12449,30.3,2003/01/02(24:00)
2003,01,01,53801,51810,38679,13131,33.9,2003/01/01(01:00)
